you	pron.你;你这个
to	prep.到;离
the	det.定冠词;表示特指
and	conj.和
that	det.那个
it	pron.它
of	prep....的;含有...的
me	pron.我
what	pron.什么;无论什么
in	prep.在...里面;在...期间
this	pron.后者;这
know	v.记住;确知
for	prep.为;为了
no	adv.不;毫不n.不;反对票
have	v.拿取;有
my	det.我的
just	adj.应得的;正义的adv.刚才;只是
not	adv.并非;不
do	v.做
be	v.表示;是
on	prep.靠近...;在...里
your	det.你的
we	pron.我们;人们
with	prep.加在...上;在...一边
so	adv.啊;同样conj.为了;因此
but	conj.但是
all	adv.单单;更其pron.全体;一切
well	adj.对的;井的adv.好;很n.好;井v.涌出;流出
he	pron.他;一个人
about	adj.活动中的prep.在...附近;在...前后
right	adj.合适的;正当的adv.好;正当地n.实况;正当v.补救;纠正
get	v.获得;取得
here	pron.这里
out	adv.出;呸prep.从...里面;从...中出来
going	adj.成功的;去的n.地面状况;去
like	adj.相同的;相像的prep.比如;像conj.好像;如同v.喜欢;要
yeah	adv.是的
if	conj.假如;使
her	pron.她
she	pron.它;她
can	aux.可以;能n.大酒杯;容器v.把...装罐保存
up	prep.往...的上端;往...的上游
want	n.缺乏;需要v.缺乏;要
think	v.想;想像
now	pron.现在
go	v.对付;忍受
him	pron.他
at	prep.向;在...里
how	adv.多少;怎样
there	pron.那里
one	n.一;一体
why	adv.为什么
see	v.察看;看
come	v.搞;来
good	adj.好的;正当的
they	pron.人们;他们
really	adv.很;说真的
as	prep.当作;像conj.当...时;像...
look	n.察看;看v.看
when	adv.其时;什么时候conj.其时;一...就
time	n.时间;时刻v.调准;为...定时
will	aux.将;能n.决心;意愿
okay	adj.表示同意的adv.好n.同意v.批准
back	adj.背后的;边远的adv.往回;向后n.背;缸v.使后退;后退
mean	adj.卑鄙的;低劣的n.平均;中间v.意味着;意指
tell	v.吩咐;讲
from	prep.从;从...来
hey	adv.嘿
yes	adv.不对;是n.是;赞成票
his	pron.他的;它的
or	conj.或者
something	pron.某;某物
who	pron.谁;他
because	conj.因为
some	pron.很多;一些
then	pron.那时
say	adv.哎呀;大约n.决定权;细哔叽v.讲述;说
ok	adj.表示同意的adv.好n.同意v.批准
take	n.捕猎;拿v.拿;执住
an	det.一
way	n.方法;方面
us	n.美国pron.人们;我们
little	adj.小的;幼小的adv.毫不;难得
make	n.牌子;体质v.构成;做
need	aux.须要n.缺少;需要v.缺少;需要
never	adv.不;从不
too	adv.很;太
love	n.爱;爱情v.爱;恋爱
sure	adj.可靠的;确信的adv.当然;无疑
them	pron.那些;他们
more	adj.更大的;另外的adv.更;再
over	adv.报文完;下prep.高于;在...的上方
our	det.我们的
sorry	adj.难过的;内疚的
where	adv.在哪里;在那里conj.然而;在...处
let	n.出租;租户v.使;允许
thing	n.事;物
am	v.be的第一人称现在时形式
maybe	adv.或许n.可能性
down	prep.往...的下端;沿
man	n.男子;人
very	adv.非常
by	prep.偏于;在...旁边
anything	pron.任何事物
much	adv.常常;十分
any	adv.多少;略pron.若干
life	n.生命;一生
even	adj.均匀的;平的adv.甚至;完全v.使平衡;使平坦
off	prep.离...;偏离...
please	adv.请;行v.乐于;敬请
do	v.做
thank	v.感谢;谢谢
give	v.给予;交给
only	adj.独生的;唯一的adv.不料;只
help	n.帮助;补救办法v.帮助;助
two	n.第二;二
talk	n.讲话;闲话v.讲;谈论
people	n.人;人民v.居住于;使充满
god	n.上帝n.男神;神
still	adj.静止的;平静的adv.还是;还要v.静止;渗出
wait	n.等待;幕间时间v.等待;等
into	prep.朝;进
find	n.发现;发现物v.发现;找出
nothing	pron.没有东西
again	adv.到原处;又
thing	n.事;物
call	n.号声;呼叫v.呼唤;叫
great	adj.大的;久的n.大人物
before	adv.较早;以前prep.在...前面;在...以前conj.不愿...;在...以前
better	adv.多;更好地v.超过;改善good的比较级
ever	adv.总是
night	n.黑夜;夜
than	conj.比;除...
away	adv.走吧;走开
first	adj.第一的;基本的adv.宁可;先
believe	v.认为;想
other	adj.别的;不同的n.对立的事物
feel	n.触;触觉v.触;发觉
everything	pron.每件事;一切
work	n.工作;职业v.经营;工作
fine	adj.快的;美好的adv.很;细小地n.罚金;租费v.使纯;变纯
home	adv.在家;在家乡n.家;家庭v.回家;有家
after	prep.随...之后;在...后面conj.在...以后
last	adj.最低的;最后的adv.上一次;最后v.度过;楦
these	det.这些
day	n.天;昼
keep	n.保持;供养v.保管;保守
doe	n.雌鹿
put	v.放;出发
around	adv.兜着圈子;在周围prep.环绕;在...各处
stop	n.停止;阻塞v.停止;阻塞
guy	n.支索;家伙v.嘲笑;乱演
long	adj.长的;长时间的adv.长久;始终v.渴望;归属
always	adv.永远;总是
listen	v.听;听从
want	n.缺乏;需要v.缺乏;要
guy	n.支索;家伙v.嘲笑;乱演
those	det.那些
big	adj.大的;洪亮的adv.成功地;大量地
lot	n.抽签;签
happen	v.发生;碰巧
thank	v.感谢;谢谢
try	n.尝试v.试;试图
kind	adj.和蔼的;友好的n.类;种类
wrong	adj.不道德的;错误的adv.不适当地;错误地n.错误;坏事v.使丢脸
through	prep.遍及;从...头至尾
talk	n.讲话;闲话v.讲;谈论
new	adj.新的;新鲜的
be	v.表示;是
guess	n.猜测v.猜;想
hi	adv.嘿;喂
care	n.小心;忧虑v.喜欢;关心
bad	adj.坏的;顽皮的
mom	n.妈妈
remember	v.记得;牢记
together	adv.到一起;同时
dad	n.爸爸;老头
leave	n.告别;许可v.丢弃;经过
mother	n.继母;母v.生;产生醋母
place	n.场所;地方v.放置;得名次
understand	v.得知;理解
actually	adv.竟然;如今
hear	v.听;听见
baby	n.婴儿;幼畜v.轻击
nice	adj.好的;好看的
father	n.父;父亲v.生
else	adv.否则;其他
stay	n.逗留;停止v.停止;延迟
their	det.他们的
course	n.进行;行动方向v.追;跑
might	n.大量;力量
mind	n.头脑;智力v.记住;照料
every	det.每一个
enough	adj.足够的adv.够了;很
try	n.尝试v.试;试图
hell	n.地狱;黑暗势力
someone	pron.某人
own	adj.自己的n.属于自己的东西v.承认;有
family	n.户;家
whole	adj.全部的;整个的n.全部;统一体
another	pron.又一个
yourself	pron.你亲自;你自己
idea	n.计划;思想
ask	v.问
must	aux.必须;务必
old	adj....岁的;老的
look	n.察看;看v.看
woman	n.成年女子;女人
hello	adv.哈罗;嘿n.喂的招呼声
which	pron.那个;那些
year	n.年;年度
room	n.房间;一套房间v.占一房间
money	n.财产;货币
tonight	n.今夜
real	adj.逼真的;真的
son	n.儿子;女婿
hope	n.希望v.希望;相信
name	n.名字;外号v.把...叫作;给...取名字
same	adj.同样的;同一的
happy	adj.乐意的;愉快的
pretty	adj.妙的;漂亮的
saw	n.锯;锯床v.锯;锯成
girl	n.女孩子;女仆
sir	n.老兄;先生;爵士
show	n.演出;展览v.陈列;给...看
friend	n.朋友;赞助者
already	adv.马上;已经
say	adv.哎呀;大约n.决定权;细哔叽v.讲述;说
next	adj.紧邻的;居后的adv.接下去;下次
three	n.第三;三
job	n.工作;职业
problem	n.难弄的人;问题
minute	adj.快熟的;微小的n.分
world	n.世界
think	v.想;想像
honey	adj.蜂蜜的;心爱的n.蜂蜜;花蜜v.说亲切话
matter	n.实体;事情v.化脓;要紧
myself	pron.我亲自;我自己
exactly	adv.精确地;正
ah	adv.啊
probably	adv.很可能
happen	v.发生;碰巧
hurt	n.打击;伤v.弄痛;痛
boy	n.男孩;男子
both	adv.在两方面同样地pron.两者
while	conj.虽然;直到v.消磨
dead	adj.不动的;死亡的adv.全然地;直接地
alone	adj.单单;单独的adv.单独地;仅仅
since	adv.从那以后;之前prep.自...以来conj.因为;自...以来
excuse	n.藉口;歉意v.为...辩解;原谅
start	n.惊跳;开始v.出现;惊动
kill	n.击落;杀死v.冻死;杀死
hard	adj.坚硬的;紧的adv.坚硬地;困难地
today	n.今天;现在
car	n.车厢;小汽车
ready	adj.快要...的v.使准备好;准备好
until	prep.向;在...之前conj.在...以前;直到...时
without	adv.外表上;在外面prep.不;无
whatever	pron.不管什么;诸如此类
want	n.缺乏;需要v.缺乏;要
hold	n.拿;船舱v.表现;掌着
yet	adv.还;迄今;尽管
deal	n.待遇;交易v.发;分配
once	adv.一次;一旦conj.一旦...
call	n.号声;呼叫v.呼唤;叫
morning	n.初期;破晓
friend	n.朋友;赞助者
head	n.上端;头v.长头;发源
stuff	n.料子;物品v.填没;饱食
most	adv.极其;最
us	n.美国pron.人们;我们
worry	n.担心;撕咬v.撕咬;担心
second	adj.次要的;第二的adv.第二;以第二位n.秒;片刻v.赞成;支持
part	n.一部分;组成部分v.放弃;分开
live	adj.活的;真的adv.在现场v.过;活
truth	n.实情;事实
school	n.上学;学校v.教育;控制
face	n.表面;脸v.面朝;朝
forget	v.忘;健忘
true	adj.纯正的;真的adv.纯种地;真实地v.装准
business	n.交易;职业
each	adv.对各个pron.各个
cause	n.理由;事业v.使;使产生
soon	adv.不久;早
know	v.记住;确知
few	adj.很少的;有些pron.很少数;少数
tell	v.吩咐;讲
wife	n.妇人;妻子
use	n.用;用途v.发挥;用
chance	adj.偶然的n.机会;机缘v.冒...的险;碰巧
run	n.跑步;赛跑v.跑;逃
move	n.搬家;动v.动;调动
anyone	pron.任何人
person	n.家伙;人
bye	adv.再见n.轮空;余穴
somebody	pron.某人
heart	n.内心;心
such	adj.那么的;这种的
miss	n.失败;逃脱v.没找到;失败
point	n.尖;尖形部件v.显示;指
later	adv.后来;再见late的比较级
meet	n.集合;集会v.接;遇见
anyway	adv.随随便便地
many	adj.许多的pron.许多人
phone	n.受话器;音子
reason	n.理由;理智v.劝喻;讨论
damn	adv.该死n.丝毫;咒骂v.使失败;咒骂
look	n.察看;看v.看
bring	v.促使;出产
case	n.框;箱v.探察
turn	n.翻动;旋动v.翻动;旋动
wish	n.请求;希望v.但愿;祝
tomorrow	n.来日;明天
kid	n.小孩;欺骗v.产;产羔
trust	n.信任;信心v.想;信任
check	n.停止;制服v.核对;击退
change	n.改变;更动v.改变;换去
end	n.端;终止v.结束;胜过
late	adj.迟的;晚的adv.迟;晚
five	n.五
least	adj.最少的adv.最少n.最少量
town	n.城市;镇
work	n.工作;职业v.经营;工作
year	n.年;年度
make	n.牌子;体质v.构成;做
mean	adj.卑鄙的;低劣的n.平均;中间v.意味着;意指
brother	n.兄弟;挚友
play	n.比赛;玩v.开;玩
hate	n.仇恨v.不愿;仇恨
ago	adv.以前
say	adv.哎呀;大约n.决定权;细哔叽v.讲述;说
beautiful	adj.出色的;美的
fact	n.事实;细节
crazy	adj.蠢的;发疯的
party	adj.共有的;政党的n.党;队;聚会
sit	v.骑;坐
open	adj.开着的;空旷的n.旷野;露天v.开;开辟
afraid	adj.恐惧的;遗憾的
between	adv.在中间prep.联接着...;在...之间
important	adj.重要的;自负的
rest	n.长眠;平静v.长眠;休息
fun	adj.古怪的n.嘲笑;娱乐
kid	n.小孩;欺骗v.产;产羔
word	n.词;话v.通知;讲话
watch	n.手表;守卫v.保卫;等待
glad	adj.高兴的;乐意的
everyone	pron.每人
day	n.天;昼
sister	n.姐妹
minute	adj.快熟的;微小的n.分
everybody	pron.每人
couple	adj.两个n.夫妻;一对v.联想;连接
either	adv.也pron.任何一个
feel	n.触;触觉v.触;发觉
daughter	n.女儿;女性后裔
get	v.获得;取得
ask	v.问
under	prep.在...之下
break	n.破裂;破晓v.打破;破坏
promise	n.可能;允诺v.向...保证;允诺
door	n.门;门状物
set	n.集子;一套v.放;落
close	adj.紧的;近的adv.接近地n.结束;终止v.关;关
hand	n.脚;手v.搀扶;交
easy	adj.容易的;舒适的adv.缓慢地;容易地
question	n.难题;问题v.怀疑;问
doctor	n.巫医;医生v.修改;修理
far	adj.较远的;远的adv.远
walk	n.行走路程;走v.走遍;走
need	aux.须要n.缺少;需要v.缺少;需要
trouble	n.烦恼;困难v.麻烦;折磨
mine	n.矿;矿藏pron.我的v.采;开矿
though	adv.可是;尽管conj.可是;即使
time	n.时间;时刻v.调准;为...定时
different	adj.差异的;各别的
kill	n.击落;杀死v.冻死;杀死
hospital	n.兽医院;医院
anybody	pron.任何人
wedding	n.婚礼;结婚
shut	v.关上;合上
able	adj.得以...的
die	n.板牙;模具v.遭受;死
perfect	adj.完好的;完美的v.使精通;使完美
police	n.警察;警察部门v.管理
stand	n.停住;站立v.经受;容忍
come	v.搞;来
hit	n.击;碰撞v.打;碰撞
story	n.情节;小说
wait	n.等待;幕间时间v.等待;等
dinner	n.客饭;宴会
against	prep.对...不利;逆
funny	adj.滑稽的;耍花招的n.滑稽戏;笑话
husband	n.夫;管家v.持有;使有丈夫
almost	adv.几乎
stupid	adj.麻木的;无聊的
pay	n.报偿;付钱v.付;付款
answer	n.答案;反应v.回应;回击
four	n.四;匍匐
office	n.办公室;处
cool	adj.冷静的;凉的n.冷淡;冷静v.变凉;减缓
eye	n.目光;视力v.看;考虑
news	n.消息;新闻
child	n.小孩;婴儿
half	n.半;半场
side	n.边;旁边v.同意;赞助
yours	pron.你的
moment	n.片刻;时机
sleep	n.昏睡;睡眠v.供...睡觉;睡
start	n.惊跳;开始v.出现;惊动
young	adj.年轻人的;幼小的
sound	adj.健康的;牢固的n.声;音v.宣告;发音
lucky	adj.侥幸的;有好运的
pick	n.掏;凿v.掏;凿
sometimes	adv.以前;有时
bed	n.床;卧室v.睡;性交
also	adv.也;而且;同样地
date	n.日期;时期v.过期;注有日期
line	n.纹路;线v.出局;填
plan	n.方法;计划v.计划;设计
hour	n.时间;小时
lose	v.失去;遗失
fire	n.电炉;火v.烧制;发热
free	adj.自由的adv.免费地;松开着v.使摆脱;使自由
hands	n.拥有;控制
serious	adj.认真的;严肃的
shit	adv.呸n.腹泻;屎v.拉;拉屎
behind	adv.在背后;在过去n.后卫;屁股prep.落后于;在...后面
inside	n.里面;内脏prep.在...的肚内;在...里面
high	adj.高的;高地的adv.高;高价的n.高地;高峰
ahead	adv.向前;在将来
week	n.工作周;星期
wonderful	adj.精彩的
fight	n.战斗;争吵v.打;奋斗
cut	n.切;切口v.切;凿
quite	adv.很;完全
number	n.数目;算术v.把...编号;计数
sick	adj.病人的;恶心的v.使厌恶
game	adj.猎物的;跛的n.游戏;运动v.赌掉;赌博
eat	v.吃;咬
nobody	pron.没有人
death	n.灭亡;死
along	prep.沿着;依照
save	prep.除...外v.储蓄;救助
seem	v.感到好像;好像发生
final	adj.决定性的;最后的n.决赛;期终考试
live	adj.活的;真的adv.在现场v.过;活
upset	n.吵架;翻倒v.打乱;弄翻
book	n.卷;书v.预订;预订
seem	v.感到好像;好像发生
sort	n.性质;种类v.拣出;符合
safe	adj.安全的;谨慎的n.保险箱;家用冰箱
front	adj.前面的;正面的n.前面;正面v.对抗;面向
ask	v.问
clear	adj.纯色的;清晰的adv.离开着;完全v.扫清;变晴
figure	n.价格;数字v.计算;出现
hot	adj.辣的;热的
six	n.第六;六
parent	n.父亲;祖先v.做...的父亲
drink	n.喝酒;饮料v.喝
absolute	adj.纯粹的;道地的n.绝对;绝对事物
daddy	n.典范
sweet	adj.甜的;悦耳的n.甜食;甜味
alive	adj.存在的;活着的
sense	n.感官;感觉v.检测;了解
happen	v.发生;碰巧
special	adj.特殊的;异常的n.特刊;专列
bet	n.打赌;赌金v.敢说;打赌
blood	n.血;血统
lie	n.谎言;躺v.说谎;平卧
full	adj.彻底的;满的
meet	n.集合;集会v.接;遇见
dear	adj.可爱的;亲爱的adv.非常;呵n.可爱人;亲爱的
coffee	n.咖啡;咖啡豆
see	v.察看;看
sound	adj.健康的;牢固的n.声;音v.宣告;发音
fault	n.错误;缺点v.产生断层;犯错误
water	n.矿泉水;水v.喷淋;饮水
ten	n.第十;十
welcome	adj.被允许的;受欢迎的n.欢迎;欢迎的话v.欢迎;迎接
buy	n.购买v.获得;买
month	n.月
hour	n.时间;小时
speak	v.讲;说
lady	n.贵妇人;女士
think	v.想;想像
body	n.躯干;肉体
order	n.次序;整齐v.命令;整理
outside	n.外表;外面prep.除了;在...的外面
hang	v.吊死;悬挂
possible	adj.可能的
worse	adv.更坏;更猛烈地bad的比较级
company	n.公司;群
mistake	n.错误;误解v.误解;误认
handle	n.把柄;柄v.操作;触
spend	v.花;用
total	adj.完全的;总的n.总数v.总数达;总计
control	n.管制;指挥v.统制;抑制
marriage	n.结婚;结婚仪式
realize	v.实现;领悟
power	n.力;能力v.促进
president	n.主管人;总统
unless	conj.除非
sex	n.男人;性v.性交
girl	n.女孩子;女仆
send	v.发送;派遣
need	aux.须要n.缺少;需要v.缺少;需要
scar	n.疤;痕v.在...上结疤;结疤
picture	n.画v.绘;映出
talk	n.讲话;闲话v.讲;谈论
ass	n.驴;傻瓜
hundred	n.第一百;一百
complete	adj.十足的;完成的v.使完美;完成
explain	v.讲解;解释
play	n.比赛;玩v.开;玩
certainly	adv.当然;无疑地
sign	n.标志;符号v.签;写下
boy	n.男孩;男子
love	n.爱;爱情v.爱;恋爱
hair	n.毛;头发
choice	adj.上等的;中上级的n.选择;选择时机
anywhere	pron.任何地方
secret	adj.秘密的;能保密的n.奥秘;秘密
future	n.将来;前途
weird	adj.超自然的;奇怪的n.命运;魔力
luck	n.好运;运气v.凑巧碰上;逢凶化吉
turn	n.翻动;旋动v.翻动;旋动
touch	n.触;触觉v.触摸;触摸
kiss	n.轻拂;吻v.轻拂;吻
question	n.难题;问题v.怀疑;问
obvious	adj.挡道的;显然的
wonder	n.惊奇;奇迹v.感到惊讶;感到疑惑
pain	n.痛;痛苦
call	n.号声;呼叫v.呼唤;叫
somewhere	pron.某处
throw	n.冒险;投掷v.发射;投
straight	adj.整齐的;直的adv.立即;直
cold	adj.感觉冷的;冷的adv.突然地;完全地n.感冒;冷
fast	adj.快的adv.快n.禁食;禁食期v.节制饮食;禁食
word	n.词;话v.通知;讲话
food	n.食物;养料
none	pron.没有一个;没有一人
drive	n.驾驶;紧迫v.逼迫;赶
work	n.工作;职业v.经营;工作
marry	v.娶;结婚
light	adj.淡色的;轻的adv.轻装地n.光;光感v.点;照亮
test	n.化验;试验v.化验;考验
drop	n.滴;微量v.滴
city	n.城市;全市居民
dream	n.出神;梦v.做;想
protect	v.保护
twenty	n.第二十;二十
class	n.班级;课
surprise	n.惊奇;突然袭击v.撞见;惊奇
its	det.它的
sweetheart	n.好心人;亲爱的人
forever	adv.老是;永远
poor	adj.贫乏的;贫穷的
look	n.察看;看v.看
mad	adj.发狂似的;疯的
except	prep.除...外conj.除非;除了v.把...除外;反对
gun	n.鸣放;炮v.向...开枪;加大油门
dance	n.跳舞;舞v.舞;舞动
take	n.捕猎;拿v.拿;执住
appreciate	v.重视;涨价;鉴赏
especial	adj.亲近的;特别的
situation	n.情况;位置
besides	adv.此外;而且prep.除...之外
week	n.工作周;星期
pull	n.拉;拉力v.采;拉
himself	pron.他亲自;他自己
act	n.幕;行为v.扮演;演
worth	adj.值钱的n.价值;经济价值prep.具有...价值;拥有...财产
top	adj.顶的;最高的n.顶;盖v.盖;结束
expect	v.等待;预计
rather	adv.宁可;有几分
swear	v.宣;宣誓;咒骂
piece	n.件;片v.接;拼合
busy	adj.忙的v.使忙于;忙碌
law	n.法律;法制
happen	v.发生;碰巧
movie	n.电影;电影业
catch	n.捕获物;抓v.接住;抓住
country	n.地区;国
less	adj.较小的adv.较小地
perhaps	adv.或许
step	n.步;步态v.跨;踩
fall	n.降落;落下v.砍倒;跌倒
watch	n.手表;守卫v.保卫;等待
darling	adj.宠爱的;可爱的n.宠儿;亲爱的
dog	n.公狗;狗v.跟踪;困扰
win	n.胜利;赢得物v.赢得;成功
air	n.空气;天气v.晾;晾
honor	n.名誉;荣誉v.使增光;尊敬
personal	adj.个人的;亲自的
till	prep.及于;在...以前conj.在...以前;直到...为止
admit	v.承认;接受
problem	n.难弄的人;问题
murder	n.谋杀;破坏v.扼杀;谋杀
strong	adj.极大的;强壮的adv.强烈地;强有力地
evil	adj.讨厌的;邪恶的n.坏事;祸害
definite	adj.明确的;限定的
feel	n.触;触觉v.触;发觉
honest	adj.诚实的;真诚的
eye	n.目光;视力v.看;考虑
broke	adj.不名一文的
miss	n.失败;逃脱v.没找到;失败
longer	adj.较长
dollar	n.美元;一元银币
evening	n.傍晚;后期
human	adj.人的;似人类的n.人
start	n.惊跳;开始v.出现;惊动
red	adj.红的;通红的n.红;红球
entire	adj.单一的;全部的
trip	n.绊;旅行v.将...绊倒;旅行
club	n.大头棒;球棒v.缴纳;捐献
suppose	v.猜想;假定
calm	adj.安静的;平静的n.安静;镇静v.使平静;平静下来
imagine	v.猜想;想
fair	adj.公正的adv.公正地;正面地n.美;女人
blame	n.责任;指责v.指责;诅咒
street	n.街;街区
favor	n.得宠;恩惠v.赐与;喜爱
apartment	n.房间;一套房间
court	n.法庭;球场v.招致;求爱
terrible	adj.可怕的;困难的
clean	adj.纯洁的;清洁的adv.干净地;完全地v.剥光;被打扫
learn	v.发现;学
work	n.工作;职业v.经营;工作
relax	v.放宽
million	n.百万;许多
charity	n.慈悲;施舍
accident	n.机遇;意外事情
wake	n.守候;守夜v.唤醒;醒
prove	v.表现;证明
smart	adj.聪明的;漂亮的adv.聪明地;漂亮地n.聪明;剧痛v.引起...剧痛;感到剧痛
message	n.启示;信息v.通报
miss	n.失败;逃脱v.没找到;失败
small	adj.细小的;小的n.狭窄部分;小件物品
interest	n.利益;趣味v.使参与;使感兴趣
table	n.一桌酒菜;桌子v.把...列表
become	v.适合;变成
mouth	n.口;人v.说;做鬼脸
pregnant	adj.充盈的;怀孕的
middle	adj.中部的;中等的n.中部;中等货
ring	n.戒指;金环v.发;鸣
careful	adj.关切的;精确的
shall	aux.将要;一定
dude	n.城里人;人
team	n.队;一组马v.结成一队
ride	n.骑;骑马道v.骑;乘坐
figured	adj.有花纹的;有形状的
wear	n.穿;服装v.穿着;蓄
shoot	n.射击;芽v.发射;开
stick	n.棍;木条v.刺;停留
follow	v.跟随;伴随
angry	adj.发怒的;狂暴的
instead	adv.反而;作为替代
write	v.记述;写
early	adj.早的;早期的adv.从前;早
war	n.斗争;战斗v.击败;斗争
stand	n.停住;站立v.经受;容忍
forgive	v.豁免;容许
jail	n.监狱v.监禁
wear	n.穿;服装v.穿着;蓄
lunch	n.快餐店;午餐v.吃午饭
eight	n.八;第八
hop	n.毒品;忽布v.飞越;跳过
thousand	n.第一千;一千
ridge	n.脊;山脊v.翻...作垄;装脊
music	n.音乐;音乐伴奏
paper	n.文件;纸v.用纸包起;贴糊墙纸
tough	adj.不嫩的;黏的n.粗暴的人
tape	n.彩带;带子v.用狭带装订
state	n.心情;形态v.陈述;确定
count	n.计算;数数v.数;值
college	n.大学;职业学校
boyfriend	n.男性友人;情人
proud	adj.感到自豪的
agree	v.承认;表示同意
birthday	n.出生的日子
bill	n.清单;帐单v.爱抚;接吻
seven	n.第七;七
history	n.过去;历史
share	n.股份;一份v.分开;分享
offer	n.发价;给予v.给予;提出
hurry	n.急忙;渴望v.急派;赶紧
wonder	n.惊奇;奇迹v.感到惊讶;感到疑惑
simple	adj.纯朴的;简单的
decision	n.决定;决议
build	n.体形;构造v.构成;建设
one	n.一;一体
finish	n.结束;抛光v.结束;用完
voice	n.禽鸣声;说话声v.给...整音;说
herself	pron.她亲自;她自己
list	n.表;布条v.列举;听
mess	n.凌乱状态v.把...弄脏;玩弄
deserve	v.应受;应受报答
evidence	n.根据;迹象v.显示;证明
cute	adj.漂亮的
dress	n.衣服;装饰v.布置;穿衣
interest	n.利益;趣味v.使参与;使感兴趣
hotel	n.饭店;公馆
enjoy	v.经历;享有
quiet	adj.安静的;寂静的n.安静;安宁v.确认;使安静
concern	n.公司;关心v.涉及;使挂念
road	n.街道;路
stay	n.逗留;停止v.停止;延迟
short	adj.矮的;短的adv.唐突地;突然地n.短路;要点v.卖空;短路
beat	adj.筋疲力尽的n.跳动v.打;拍打
mention	n.传令嘉奖;提及v.传令嘉奖;提到
clothe	v.覆盖;赋予
finish	n.结束;抛光v.结束;用完
fell	adj.残暴的;剧痛的n.折缝;山v.缝;击倒
neither	adv.也;也不pron.无一个
fix	n.方位;困境v.定居;固定
respect	n.敬意;尊敬v.关于;敬意
prison	n.监狱;牢狱v.监禁
attention	n.考虑;注意
hold	n.拿;船舱v.表现;掌着
call	n.号声;呼叫v.呼唤;叫
near	adj.近的;近似的adv.近;近似地prep.靠近v.靠近
bar	n.条;闩prep.除...外v.关;闩
pass	n.境况;通过v.超过;经过
keep	n.保持;供养v.保管;保守
gift	n.礼物;赠送
dark	adj.黑暗的;深黑n.黑色;黑暗
self	n.本性;私利
owe	v.欠;欠钱
us	n.美国pron.人们;我们
ice	n.冰;冰状物v.使凉;结冰
helping	n.帮助;一份
bitch	n.母狗;怨言v.抱怨;弄坏
normal	adj.平常的;正常的n.师范学校;正常人
aunt	n.阿姨;伯母
lawyer	n.律师
apart	adv.成距离;成零碎
certain	adj.固定的;可靠的
plan	n.方法;计划v.计划;设计
girlfriend	n.女伴;情人
floor	n.层;底v.击败
whether	conj.是...;是否
present	adj.出席的;现在的n.现在;礼物v.表示;提出
earth	n.尘世;地球v.把...接地;用土掩盖
private	adj.私立的;私人的n.平民;士兵
box	n.箱;巴掌v.打;斗拳
cover	n.书壳;掩蔽v.盖;代替
judge	n.法官;鉴定人v.裁决;断定
upstairs	adv.在高空;在楼上n.东家;楼层
sake	n.理由;目的
mommy	n.妈妈
possibly	adv.无论如何;也许
station	n.车站;站v.安置
act	n.幕;行为v.扮演;演
accept	v.承认;接受
blow	n.吹;花v.吹;吹响
strange	adj.陌生的;外地的
plane	n.平面;镘v.飞行;刨
mama	n.老婆;妈妈
yesterday	n.昨日;昔日
quick	adj.聪敏的;快的adv.紧身地;快n.活肉
lately	adv.近来
lovely	adj.心灵美的adv.漂亮地n.美女
security	n.安全;保证
report	n.报道;报告v.报道;说
difference	n.差别;特点
store	n.储存;大量v.储备;装满
bag	n.袋;猎袋v.猎获;收割
ball	n.球;舞会v.交媾;狂欢
single	adj.单程的;单人的n.单曲唱片;一个v.选出
doubt	n.迟疑;怀疑v.怀疑;迟疑
listen	v.听;听从
major	adj.较大的;较重要的n.成年人;重要人物v.主修
walk	n.行走路程;走v.走遍;走
cop	n.抓;顶v.攫;偷
blue	adj.悲伤的;蓝色的n.蓝色;蓝颜料
deep	adj.深的;有...深的adv.强烈地;深深地n.海;海渊
dangerous	adj.引起危险的
sleep	n.昏睡;睡眠v.供...睡觉;睡
record	n.记录;履历v.登记;记录
lord	n.主;君主;领主v.称...为勋爵;指挥
join	n.并;连接v.连接;参加
key	n.答案;方法v.为...调音;钉防
captain	n.船长;领袖v.率领
card	n.卡;卡片v.得;梳理
crime	n.犯罪;罪
willing	adj.愿意的
window	n.窗;窗框
return	n.回;送回v.回报;回
walk	n.行走路程;走v.走遍;走
guilty	adj.有过失的;有罪的
like	adj.相同的;相像的prep.比如;像conj.好像;如同v.喜欢;要
fight	n.战斗;争吵v.打;奋斗
difficult	adj.困难的;难懂的
soul	n.精神;灵魂
joke	n.笑话v.取笑;说笑话
service	n.服务v.检修;为...服务
magic	adj.巫术的;有魔力的n.魔法;魔力
favorite	adj.特别受喜爱的n.受宠的人
uncle	n.伯父;大伯;舅父
public	adj.公开的;公众的n.公众;一群人
bother	n.烦恼;努力v.打扰;迷惑
island	n.岛;岛状物
serious	adj.认真的;严肃的
cell	n.蜂房巢室;小牢房;细胞;电池
lead	n.指引;铅v.牵;致使
know	v.记住;确知
advice	n.报道;劝告
somehow	adv.不知何故
push	n.突出;推v.推;突出
help	n.帮助;补救办法v.帮助;助
kill	n.击落;杀死v.冻死;杀死
usual	adj.通常的
boss	adj.第一流的;领头的n.老板;领袖v.指挥;当头儿
innocent	adj.率真的;清白的n.无罪的人;新手
rule	n.裁决;规则v.控制;统治
cop	n.抓;顶v.攫;偷
learn	v.发现;学
thirty	n.第三十;三十
risk	n.危险;危险率v.把...作赌注;冒...的危险
speaking	n.说话adj.说话的
officer	n.船长;法警
ridiculous	adj.呱呱叫的
support	n.帮助;支撑v.帮助;支持
afternoon	n.后期;下午
dream	n.出神;梦v.做;想
apologize	v.道歉;辩解
seat	n.坐部;座v.供给...座位;使坐下
nervous	adj.神经的;神经质的
across	prep.穿过...;与...相交叉
song	n.歌;诗歌
charge	n.价钱;应付v.要;冲锋
patient	adj.忍耐的;有耐心的n.病人;顾客
boat	n.船v.用船装运;乘船
brain	n.脑;脑袋v.重击...的头
hide	n.皮肤;生命v.隐瞒;遮掩
detective	adj.侦查的;侦探器n.发觉者;侦探
general	adj.笼统的;全体的n.将军;上将
nine	n.第九;九
huge	adj.庞大的
breakfast	n.早餐v.进早餐
horrible	adj.极讨厌的n.可怕的人
age	n.成年;年龄v.使老;变陈
awful	adj.使人畏惧的adv.十分
pleasure	n.高兴;娱乐v.使高兴;觉得高兴
hang	v.吊死;悬挂
pick	n.掏;凿v.掏;凿
system	n.系统;制度
sell	n.欺骗;推销v.出卖;卖
quit	v.停止;放弃;离开
apparent	adj.表面上的;显然的
notice	n.警告;关注;征象v.警告;提到
chief	adj.为首的;主要的n.酋长;首领
faith	n.信任;信条
gay	adj.欢快的adv.很;卖弄地
month	n.月
visit	n.参观;视察v.访问;视察
letter	n.信;字母v.在...上刻字
decide	v.解决;决定
double	adj.两倍的;双的adv.两倍地;双双地n.酷似的人;两倍v.握紧;代替
sad	adj.悲哀的;可悲的
press	n.按;压力v.按;挤出
forward	adj.热心的;早的adv.提前地;向前n.前锋v.促进;发送
fool	n.蠢人;弄臣v.愚弄;玩弄
show	n.演出;展览v.陈列;给...看
smell	n.气味;嗅觉v.感觉到;嗅
seem	v.感到好像;好像发生
spell	n.符咒;魔力v.拼作;拼字
memory	n.回忆;记忆
picture	n.画v.绘;映出
slow	adj.耗时的;慢的adv.慢慢地v.放慢;放慢速度
second	adj.次要的;第二的adv.第二;以第二位n.秒;片刻v.赞成;支持
hungry	adj.饥饿的
board	n.板;纸板v.使搭伙;搭伙
position	n.恰当位置;位置v.安放;驻扎
hear	v.听;听见
kitchen	n.厨房;厨师
force	n.力;武力v.强迫;逼叫
fly	n.苍蝇v.使飞;飞
during	prep.在...期间的某一时候
space	n.场地;空间v.分隔开;留间隔
experience	n.经历;经验v.经历
kick	n.踢;踢球v.踢;反冲
other	adj.别的;不同的n.对立的事物
grab	n.抓;抓具v.逮住;抓
discuss	v.论述;品尝
third	n.第三;三分之一
fifty	n.第五十;五十
fat	adj.肥胖的;育肥的n.肥肉;脂肪
idiot	adj.极愚蠢的n.白痴;傻子
rock	n.大石;矿石v.轻摇使;轻摆
rich	adj.富的;富饶的
sudden	adj.突然的;迅速的
agent	n.代理人;动源
bunch	v.打褶;凸出
destroy	v.打破;破坏
buck	adj.雄的adv.完全地n.鹿皮;男人v.顶撞;反抗
track	n.轨道;小道v.跟踪;走过
shoe	n.蹄铁;鞋
scene	n.地点;一场
peace	n.和平;和约
arm	n.臂;军种v.提供;武装起来
demon	n.恶魔;恶人
low	adj.低的;浅的adv.低;低声地
consider	v.考虑;认为
paper	n.文件;纸v.用纸包起;贴糊墙纸
medical	adj.内科的;药的
incredible	adj.难以置信的
witch	n.丑老太婆;女巫v.迷住;向...施巫术
attorney	n.代理人;律师
tell	v.吩咐;讲
knock	n.一击;指责v.敲;敲
way	n.方法;方面
give	v.给予;交给
department	n.部;省
nose	n.鼻子;气味v.探出;嗅
turn	n.翻动;旋动v.翻动;旋动
keep	n.保持;供养v.保管;保守
beer	n.啤酒;汽水
jealous	adj.妒忌的;妒羡的
care	n.小心;忧虑v.喜欢;关心
plenty	adj.很多的adv.充分地n.丰富;富裕
extra	adj.额外的;特佳的adv.额外地;特别地n.号外
tea	n.茶;茶叶
attack	n.攻击;侵蚀v.攻击
whose	det.谁的
weekend	n.周末;周末聚会v.过周末
matter	n.实体;事情v.化脓;要紧
type	n.类型v.翻印;打字
king	n.大王;君主
impossible	adj.不可能的
book	n.卷;书v.预订;预订
machine	n.机动车;机器v.使定型
waste	n.废料;浪费v.浪费;消耗
pretend	v.伪称;装扮
danger	n.危险;危险示意
wall	n.壁;墙v.给...建墙;转动
jump	n.跳;心神不安v.使跳;跳
eat	v.吃;咬
proof	n.证据;证明v.检验;校对
complete	adj.十足的;完成的v.使完美;完成
career	n.成功;全速;职业;专业v.使奔驰;奔驰adj.职业的
arrest	n.逮捕;停止v.逮捕;吸引
star	n.星;星宿v.用星装饰;当明星
breathe	v.呼吸;吸入
perfect	adj.完好的;完美的v.使精通;使完美
warm	adj.感到热的;温暖的v.取暖;同情
pull	n.拉;拉力v.采;拉
twice	adv.两倍;两次
killer	n.杀灭物;杀人者
suit	n.套;衣服v.适合;合适
romantic	adj.有浪漫色彩的n.浪漫的人
find	n.发现;发现物v.发现;找出
check	n.停止;制服v.核对;击退
fit	adj.健康的;适合的n.合身;配合v.配合;适合
divorce	n.分离;离婚v.判...离婚;离婚
begin	v.开始
ourselves	pron.我们亲自;我们自己
ruin	n.毁灭;破产v.毁坏;毁灭
although	conj.虽然;尽管
smile	n.欢快;微笑v.露出;惠及
laugh	n.笑;笑柄v.开颜;笑
fish	n.鱼;鱼肉v.捕;捕鱼
treat	n.款待;乐事v.对待;看待
fear	n.害怕;可能性v.害怕;恐怕
otherwise	adv.别样;不然
mail	n.邮件;邮政v.邮寄;寄出
cost	n.代价;价钱v.价钱为;使付出
stole	n.长袍;圣带
excellent	adj.非常的;较高的
bring	v.促使;出产
pop	n.爸爸;大伯v.敲击;突然行动
bottom	adj.底部的;基础的n.底;枯谷v.使基;基于
note	n.按语;短笺v.记录;注意
sudden	adj.突然的;迅速的
church	n.礼拜;礼拜堂
bathroom	n.厕所间;浴室
flight	n.飞翔;抽逃
honestly	adv.的确;咳
sing	v.唱;啼
foot	n.脚;最下部v.步行;结算
game	adj.猎物的;跛的n.游戏;运动v.赌掉;赌博
glass	n.玻璃;镜子v.反射;给...装玻璃
remind	v.说...以提醒;提醒
bank	n.岸;堆v.开银行;做庄家
charge	n.价钱;应付v.要;冲锋
witness	n.证据;证人v.目击;作证
find	n.发现;发现物v.发现;找出
place	n.场所;地方v.放置;得名次
tree	n.木制用具;树v.在...上植树;爬上树
dare	n.大胆;挑战v.敢;敢做
hardly	adv.不十分;几乎不
interest	n.利益;趣味v.使参与;使感兴趣
steal	n.偷盗v.偷盗;偷垒
princess	n.公主;女王;王妃
silly	adj.无聊的;晕眩的n.傻瓜
contact	n.接触;熟人v.使接触;接触
teach	v.教;教导
shop	n.购物;商店;营业v.选购;浏览
plus	n.加号;正量prep.加;外加
colonel	n.长官;上校
fresh	adj.另外的;新的
trial	adj.审讯的;试验的n.麻烦;试
roll	n.小圆面包;一卷v.卷;推
radio	n.收音机;无线电v.用无线电发送
art	n.美术;艺术
reach	n.地带;伸出v.到达;伸出
dirty	adj.肮脏的;污染的adv.肮脏地;很v.弄脏;玷污
choose	v.情愿;欲;挑选
emergency	n.急症;紧急情况
butt	n.残端;靶v.捻熄;碰撞
credit	n.信任;信誉v.把...归于;信任
obvious	adj.挡道的;显然的
cry	n.叫喊;哭v.哭;鸣
lock	n.锁;闸v.拴住;锁
positive	adj.武断的;有把握的
nuts	adj.发疯的;狂热的nut的复数
goodbye	n.告别
condition	n.健康状况;状况v.使健康;训练
guard	n.警戒;警卫员v.保守;看守
grow	v.种;长
cake	n.饼;糕饼v.结块
mood	n.心境;式
total	adj.完全的;总的n.总数v.总数达;总计
crap	adv.胡扯n.废物;屎v.把...搞乱;拉屎
cry	n.叫喊;哭v.哭;鸣
belong	v.合适;属
lay	adj.世俗的;外行的n.层;歌曲v.置放;产卵
partner	n.搭档;伙伴v.使合伙;合伙
trick	n.诡计;技巧v.打扮;哄骗
pressure	n.按;困扰v.使增压;施加压力
arm	n.臂;军种v.提供;武装起来
dress	n.衣服;装饰v.布置;穿衣
cup	n.杯;杯子v.用杯盛;拔火罐
lie	n.谎言;躺v.说谎;平卧
bus	n.公共汽车;汽车v.用四轮手推车送
taste	n.尝;味v.尝;吃
neck	n.颈肉;颈项v.割颈杀;变狭
south	adj.南部的;在南方的adv.向南方n.南;南部
nurse	n.保姆;护士v.调养;当保姆
raise	n.高岗;提高v.举起;竖起
land	n.地产;陆地v.靠岸;落下
cross	adj.交叉的;相互的adv.横跨地n.十字架v.穿过;交叉
lot	n.抽签;签
mister	n.平民;先生
carry	n.射程;运载v.提;携带
group	n.集体;组v.簇射;形成组
whoever	pron.谁;无论谁
drink	n.喝酒;饮料v.喝
break	n.破裂;破晓v.打破;破坏
file	n.文件夹;锉刀v.发送;锉
lock	n.锁;闸v.拴住;锁
computer	n.计算机;计算器
wine	n.葡萄酒;药酒v.喝酒
spot	n.疤点;点子v.使有污渍;玷污
pay	n.报偿;付钱v.付;付款
study	n.学科;学习;研究v.记住;学习;研究
assume	v.呈现;承担
asleep	adj.长眠的;麻木的
turning	n.旋转;转弯处
legal	adj.法律的;合法的
justice	n.公正;正确
bedroom	n.卧铺单间;卧室
shower	n.一大批;阵雨v.喷淋;洗淋浴
camera	n.暗箱;照相机
fill	n.充分;装填物v.挤满;装满
reason	n.理由;理智v.劝喻;讨论
forty	n.第四十;四十
nope	adv.不
key	n.答案;方法v.为...调音;钉防
breath	n.呼吸;气息
doctor	n.巫医;医生v.修改;修理
pants	n.裤子;短裤
freak	adj.反常的n.畸形;主意突变v.扰乱;胡闹
level	adj.平的;一般高的n.基准面;水平面v.击倒;瞄准
movie	n.电影;电影业
action	n.行动;行为
area	n.地区;面积
folk	adj.现代民间音乐的n.各位;家属
cream	n.奶油;奶油汤v.结奶油;射精
continue	v.继续;延伸
focus	n.焦点;焦距v.集中;聚焦
wild	adj.野生的;原始的adv.狂暴地n.野生动物
desk	n.读经台;书桌
convince	v.使确信;使知错
client	n.顾客;委托人
band	n.群;箍v.聚集
hurt	n.打击;伤v.弄痛;痛
spend	v.花;用
allow	v.允给;允许
grand	adj.崇高的;宏伟的n.一千英镑
answer	n.答案;反应v.回应;回击
shirt	n.衬衫;贴身衣
chair	n.椅子;主席v.使入座
allow	v.允给;允许
rough	adj.不平滑的;未加工的n.粗人v.对...动粗;使不平
see	v.察看;看
government	n.政府;政体
ought	v.欠;占有
empty	adj.空的;空虚的n.空瓶v.使空;流出
round	adj.丰满的;圆的n.圆圈;圆形物prep.围绕;向...各处v.变圆;环行
light	adj.淡色的;轻的adv.轻装地n.光;光感v.点;照亮
insane	adj.蠢极的;精神病的
hat	n.贿赂;帽子
bastard	adj.私生的;野种的n.劣等货;杂种
wind	n.风;圈;气息v.包;绕
show	n.演出;展览v.陈列;给...看
aware	adj.懂事的;意识到的
deal	n.待遇;交易v.发;分配
pack	n.包;小包v.挤;洗
mean	adj.卑鄙的;低劣的n.平均;中间v.意味着;意指
flower	n.花;精华v.发育;开花
tight	adj.紧的;紧身的adv.充分地;紧
hurt	n.打击;伤v.弄痛;痛
ship	n.船;飞船v.用船运;上船
subject	adj.臣服的;需要...的n.题目;学科v.使臣服;提供
guest	n.客;旅客
chicken	adj.胆小的;鸡肉的n.家禽;小鸡v.胆怯
pal	n.好友;同谋v.交友
match	n.火柴;火绳v.结婚;相称
arrest	n.逮捕;停止v.逮捕;吸引
sun	n.恒星;日光v.晒;晒太阳
surgery	n.手术;外科
expect	v.等待;预计
lab	n.实验室
pass	n.境况;通过v.超过;经过
bottle	n.奶瓶;一束v.把...装入瓶中
beyond	prep.迟于;深于
whenever	adv.无论什么时候conj.无论什么时候
pool	n.池塘;水洼v.开;淤积
opinion	n.评价;意见
naked	adj.赤裸裸的;光赤的
common	adj.公共的;普通的n.共用牧地
start	n.惊跳;开始v.出现;惊动
jerk	n.颠簸;反射v.颠簸;猝然一动
secret	adj.秘密的;能保密的n.奥秘;秘密
fall	n.降落;落下v.砍倒;跌倒
play	n.比赛;玩v.开;玩
necessary	adj.必然的;必要的
barely	adv.公开地;仅仅
health	n.健康;卫生
test	n.化验;试验v.化验;考验
copy	n.本;原件v.抄袭;抄写
video	n.电视;录像
cousin	n.堂兄弟;远亲
dry	adj.干的;干燥的v.使干;变干
ahem	adj.哼
twelve	n.第十二;十二
simply	adv.简单地;仅仅
skin	n.皮;外皮v.剥去...的皮;蜕皮
often	adv.常常;通常
fifteen	n.第十五;十五
spirit	n.精神;灵魂v.鼓励;偷偷地走
speech	n.说话;说话方式
name	n.名字;外号v.把...叫作;给...取名字
issue	n.河口;结果v.发行;分配
order	n.次序;整齐v.命令;整理
final	adj.决定性的;最后的n.决赛;期终考试
result	n.获胜;结果v.发生;结果
code	n.编号;编码v.为...编码
research	n.研究;研究才能v.研究
nowhere	pron.没有地方
escape	n.逃路;逃跑v.逃脱;漏出
restaurant	n.餐馆
grateful	adj.感激的
usual	adj.通常的
burn	n.燃烧;烧伤v.点燃;烧掉
address	n.地址;演说v.对付;呼吁
within	adv.户内;内心prep.在...里面;在...之内
screw	n.螺钉;阳螺旋v.操纵;旋
everywhere	pron.每一处
train	n.连串;列车v.把...对准;训练
film	n.薄层;胶片v.拍摄;拍摄电影
regret	n.懊悔;道歉v.痛惜;因...懊悔
goodness	n.精华;善
mistake	n.错误;误解v.误解;误认
detail	n.细部;细节v.列举;详述
suspect	adj.可疑的n.被怀疑的人v.怀疑;疑有
corner	n.包角;角v.垄断;转弯
hero	n.男主角;英雄
dumb	adj.笨的;哑的v.使沉默;变哑
terrific	adj.极好的;可怕的
mission	n.传教团;外交使团
further	adv.此外;更远地v.促进far的比较级
gas	n.麻醉气;气v.加汽油;空谈
hole	n.巢穴;洞v.打;打洞
truck	n.交易;商品v.叫卖;打交道
follow	v.跟随;伴随
end	n.端;终止v.结束;胜过
ruin	n.毁灭;破产v.毁坏;毁灭
split	n.分裂;裂口v.分担;劈开
bear	n.玩具熊;熊v.忍;压
airport	n.机场
bite	n.咬;咬的伤痕v.刺穿;咬
smoke	n.抽烟;烟v.抽;熏制
liar	n.说谎的人
horse	n.马;骑兵v.发情;上马
show	n.演出;展览v.陈列;给...看
project	n.工程;计划v.打算;投掷
card	n.卡;卡片v.得;梳理
desperate	adj.绝望的
themselves	pron.他们亲自;他们自己
search	n.检查;搜查v.探;细察
pathetic	adj.不足的;情感的
damage	n.代价;损害v.损害;受到损坏
spoke	n.辐条
quick	adj.聪敏的;快的adv.紧身地;快n.活肉
scare	n.惊吓;恐慌v.吓;吓走
beach	n.海滩;湖滨v.把...拖上岸;上岸
afford	v.买得起;提供
vote	n.票;投票v.公议;建议
settle	v.安放;定居
gold	n.金;金币
mention	n.传令嘉奖;提及v.传令嘉奖;提到
due	adj.欠款的;应给的adv.正对着n.应缴款;责任
passion	n.激怒;激情
stay	n.逗留;停止v.停止;延迟
rule	n.裁决;规则v.控制;统治
check	n.停止;制服v.核对;击退
tie	n.带;领带v.系;打结
upon	prep.覆盖;接触
head	n.上端;头v.长头;发源
concern	n.公司;关心v.涉及;使挂念
natural	adj.有关自然的n.智力低下的人
champagne	adj.香槟酒色的n.香槟酒;香槟酒色
connection	n.联系;连接
ticket	n.标签;票v.给...门票;描述
finger	n.手指;指状物v.指出;伸出
happiness	n.恰当;幸福
form	n.模型;形体v.构成;形成
kiss	n.轻拂;吻v.轻拂;吻
hat	n.贿赂;帽子
personal	adj.个人的;亲自的
suggest	v.建议;意思是
build	n.体形;构造v.构成;建设
leg	n.假腿;腿
onto	prep.到...之上;对...熟悉
leave	n.告别;许可v.丢弃;经过
downstairs	adj.在楼下的adv.在楼下n.楼下;仆人
ticket	n.标签;票v.给...门票;描述
loose	adj.放松的;宽松的adv.宽松地v.解开;释放
holy	adj.神圣的;圣洁的
staff	n.工作班子;全体职员v.雇用
sea	n.海;内海
planet	n.地球;行星
duty	n.责任;职责
throw	n.冒险;投掷v.发射;投
defense	n.辩护;防御
kiss	n.轻拂;吻v.轻拂;吻
leg	n.假腿;腿
accord	n.谅解;谐和v.授予;相符合
loud	adj.俗艳的;响亮的adv.大声地
practice	n.练习;实践
army	n.军队;陆军
warn	v.警告;通知
miracle	n.奇迹;奇事
carry	n.射程;运载v.提;携带
flying	adj.飞的;飞似的
blind	adj.盲人的;瞎的adv.盲目地;轻率地n.眼罩;遮蔽物v.比...更亮;使瞎
queen	n.酋长夫人;王后
ugly	adj.可怕的;难看的
hate	n.仇恨v.不愿;仇恨
monster	adj.巨大的n.怪兽;怪物
sight	n.检查;看见;视觉v.观测;看到
vampire	n.吸血鬼
bride	n.新娘;帽带
coat	n.皮毛;上衣v.在...上涂
account	n.记述;解释v.报帐;导致
state	n.心情;形态v.陈述;确定
clear	adj.纯色的;清晰的adv.离开着;完全v.扫清;变晴
celebrate	v.举行;庆祝
brilliant	adj.光辉的;卓越的n.最小号铅字
want	n.缺乏;需要v.缺乏;要
add	v.添加;做加法
moon	n.月光;月球v.虚度;懒散度日
lip	n.唇状物;嘴唇
custody	n.照看;羁押
screw	n.螺钉;阳螺旋v.操纵;旋
buy	n.购买v.获得;买
size	n.尺码;大v.相比;给...上涂料
toast	n.烤面包;干杯v.烤;干杯
student	n.学生;学者
however	adv.不管怎样;究竟怎样
star	n.星;星宿v.用星装饰;当明星
reality	n.实在;现实
birth	n.出生;分娩v.产生;生
attitude	n.态度;姿势
advantage	n.好处;有利地位v.有利于;获利
open	adj.开着的;空旷的n.旷野;露天v.开;开辟
grandma	n.老太太;奶奶
beg	v.恳求;请
change	n.改变;更动v.改变;换去
someday	adv.来日
grade	n.等级;阶段v.把...筑平;递变
cheese	n.干酪;要人
roof	n.顶;房屋v.给...装以特定屋面
pizza	n.比萨饼
brother	n.兄弟;挚友
sign	n.标志;符号v.签;写下
bird	n.鸟;幼鸟
marry	v.娶;结婚
powerful	adj.浓烈的;强壮的
fake	adj.假的n.假货;骗子v.伪造;伪装
open	adj.开着的;空旷的n.旷野;露天v.开;开辟
expect	v.等待;预计
eventually	adv.终于
idea	n.计划;思想
cover	n.书壳;掩蔽v.盖;代替
familiar	adj.亲近的;熟悉的n.常客;知交
bomb	n.炸弹v.大胜;轰炸
television	n.电视;电视机
color	n.颜色v.变色;脸红
heavy	adj.太贵的;重的n.肥畜;重的人
schedule	n.表;计划v.安排;将...列表
record	n.记录;履历v.登记;记录
dollar	n.美元;一元银币
capable	adj.有能力的
master	n.艺术家;主人v.精通;统治
number	n.数目;算术v.把...编号;计数
practical	adj.可实施的;实践的
correct	adj.正当的;正确的v.惩治;改正
clue	n.提示词语;线索v.为...提供线索
immediate	adj.立即的;直接的
social	adj.社会的n.社会保险;社交聚会
nature	n.大自然;禀性
deserve	v.应受;应受报答
teacher	n.教员
threat	n.威胁;凶兆
bloody	adj.嗜杀的;血污的v.使流血
lonely	adj.孤独的;寂寞的
order	n.次序;整齐v.命令;整理
shame	n.羞耻;羞辱v.感到羞耻
local	adj.局部的;位置的n.当地居民;市郊列车
jacket	n.皮毛;外罩v.打
hook	n.钩;陷阱v.钓;钩
destroy	v.打破;破坏
loser	n.输者;遗失者
above	adj.上面出现过的adv.在顶部;在上面prep.多于;高于
invite	v.请求;邀请
shooting	n.发射;射猎
merry	adj.欢乐的;轻快的
port	n.港;包v.向左转;持
precious	adj.贵重的adv.极其n.珍爱的人
lesson	n.功课;教程
criminal	adj.犯罪的;刑事的n.罪犯
grow	v.种;长
victim	n.牺牲;牺牲者
professor	n.教授;专家
follow	v.跟随;伴随
funeral	n.葬礼
dean	n.教务长;学院院长
consider	v.考虑;认为
burning	adj.发热的;燃烧的
couch	n.长榻;眠床v.表达;平握
strength	n.力;强度
loss	n.减少;损失
view	n.观看;视力v.查看;观看
beauty	n.美;美人
sister	n.姐妹
several	pron.几个
push	n.突出;推v.推;突出
shock	n.冲击;震动v.使震惊;震扰
push	n.突出;推v.推;突出
heat	n.热;体温v.使热;变热
chocolate	n.巧克力;巧克力糖
miserable	adj.贫困的;痛苦的n.遭受苦难的人
nightmare	n.梦魇;睡魔
energy	n.活力;能
bring	v.促使;出产
character	n.品德;性质
famous	adj.第一流的;著名的
enemy	n.敌国;敌军
crash	n.碰撞;坠毁v.使坠毁;坠毁
chance	adj.偶然的n.机会;机缘v.冒...的险;碰巧
send	v.发送;派遣
recognize	v.承认;明白
healthy	adj.健康的
feed	n.饲料;喂食v.维持;喂
engaged	adj.被占用的;忙的
percent	n.百分比;百分之一
head	n.上端;头v.长头;发源
line	n.纹路;线v.出局;填
treat	n.款待;乐事v.对待;看待
purpose	n.目的;效用
knife	n.刀;匕首v.用刀裁;用刀砍
right	adj.合适的;正当的adv.好;正当地n.实况;正当v.补救;纠正
drag	n.海锚;拖网v.拖;硬拉
fan	n.螺旋桨;扇子v.扇
badly	adv.坏;顽皮地
speed	n.快;速率v.促进;快走
hire	n.租金;租用v.租出;租人
curious	adj.好奇的;奇特的
paint	n.涂漆;颜料v.画;描写
pardon	n.饶恕;赦免v.免除;赦免
closet	n.橱;退避处v.把...引进密室会谈
warn	v.警告;通知
gorgeous	adj.绚丽的
post	n.柱;岗位v.宣布;押
milk	n.奶;乳剂v.抽取;出奶
survive	v.比...活得长;活下来
operation	n.操作;活动
suck	n.吸;吸食v.吸;吸食
offer	n.发价;给予v.给予;提出
end	n.端;终止v.结束;胜过
dump	n.倾倒;倾销v.倒掉;倾卸
remember	v.记得;牢记
lieutenant	n.代理官员;海军上尉
trade	n.交易;贸易v.对换;购物
rain	n.一阵;雨v.下;诉苦
revenge	n.复仇;复仇心v.报...之仇;报仇
physical	adj.物理的;物质的n.体格检查
available	adj.可获得的;在手边的
program	n.程序;程序设计v.设计程序
prefer	v.宁可;提出
spare	adj.备用的;剩下的n.备件;姘妇v.节约;宽容
pray	adv.请v.祈望;做
disappear	v.使不见;消失
aside	adv.离开;撇开n.离题的话;旁白
statement	n.陈述;声明
sometime	adj.不常有的;一度的
animal	n.动物;畜
sugar	n.食糖;糖
meat	n.肉;食物
fantastic	adj.奇异的n.古怪的人
breath	n.呼吸;气息
laugh	n.笑;笑柄v.开颜;笑
itself	adv.究竟pron.它自己;自身
tip	n.末梢;芽尖v.倾倒;翻倒
market	n.集市;市场v.销售;进行交易
affair	n.事;事情
ours	pron.我们的
depend	v.信赖;依靠
cook	n.厨子;蒸煮v.烹调;烧
babe	n.宝贝儿;婴儿
main	adj.辽阔的;完全的n.体力;叫数
wood	n.木;木材
protect	v.保护
jury	adj.暂用的n.陪审团
national	adj.国家的;国民的n.国民;全国总部
brave	adj.勇敢的;壮观的n.恶棍;勇敢的人v.向...挑战;吹嘘
storm	n.风暴;狂风v.强击;暴怒
large	adj.大的;开阔的
prince	n.国君;王子
interview	n.采访;接见;口试v.接见;面谈
football	n.足球
finger	n.手指;指状物v.指出;伸出
murder	n.谋杀;破坏v.扼杀;谋杀
sexy	adj.色情的;性感的
process	n.步骤;过程v.对...起诉;列队行进
pick	n.掏;凿v.掏;凿
style	n.派头;样式v.叫
stone	n.界石;磨石v.向...扔石块;用石铺
pieces	n.身心崩溃v.拆开
blah	n.空话
assistant	n.助教;助手
block	n.大块;街区v.堵塞;阻碍
pie	n.财富;派;馅饼
handsome	adj.好看的;慷慨的
nearly	adv.极;几乎
shake	n.握手;摇动v.撒;摇
car	n.车厢;小汽车
wherever	pron.无论哪里
serve	n.发球;轮到发球v.任;帮佣
pull	n.拉;拉力v.采;拉
point	n.尖;尖形部件v.显示;指
medicine	n.药;医学
fact	n.事实;细节
wait	n.等待;幕间时间v.等待;等
lousy	adj.多虱的;污秽的
stage	n.舞台;戏剧;阶段v.举办;展现
disappoint	v.失信于;使破灭
weak	adj.不牢固的;虚弱的
trust	n.信任;信心v.想;信任
license	v.批准;准许
community	n.社会;团体
trash	n.废话;废物
understand	v.得知;理解
slip	n.失脚;片v.滑落;滑行
cab	n.出租车
sound	adj.健康的;牢固的n.声;音v.宣告;发音
awake	adj.警觉的;醒着的v.唤起;醒
friendship	n.帮助;友好
stomach	n.胃;胃口v.承受;吃下
weapon	n.武器;袭击器官
threaten	v.警告;威胁
don	n.先生v.披上
mystery	n.奥秘;神秘
official	adj.公职的;正式的n.官员;行政人员
lee	n.庇护所;庇荫
regular	adj.定时的;恒常的n.常客;正规兵
river	n.河;巨流
valley	n.流域;山谷
contract	n.合同;合同法v.缩约;皱缩
bud	n.孩子;芽v.使发芽;发芽
sexual	adj.两性的;性的
race	n.比赛;族v.疾走;猛转
switch	n.长假发;一击v.鞭打;挥动
lake	n.池;湖
frankly	adv.非常;确实
issue	n.河口;结果v.发行;分配
cheap	adj.廉价的adv.廉价地
lifetime	n.寿期;一生
deny	v.否认;拒绝给予
paint	n.涂漆;颜料v.画;描写
ear	n.耳;穗
clock	n.示速计;钟v.测...的时间;测出
weight	n.重;重量单位v.使负重;使倾斜
garbage	n.废话;垃圾
tear	n.悲痛;撕v.流泪;撕
ear	n.耳;穗
dig	n.触;挖苦v.掘得;挖成
bullet	n.枪弹;小圆球
sell	n.欺骗;推销v.出卖;卖
indeed	adv.哦;确实
sing	v.唱;啼
tiny	adj.极小的
particular	adj.特定的;特殊的n.详情;一项
draw	n.被拉的量;拉v.拔出;拉
decent	adj.高雅的;合宜的
super	adj.极端的;特大的adv.过分地;十分
spring	n.弹性;反弹;春天v.惊起;跳
avoid	v.避开;避免
mess	n.凌乱状态v.把...弄脏;玩弄
unit	n.单位;股份单位
fill	n.充分;装填物v.挤满;装满
touch	n.触;触觉v.触摸;触摸
score	n.得分;分;乐谱v.得;赢得
disappear	v.使不见;消失
stranger	n.陌生人;生手strange的比较级
exact	adj.精密的;精确的v.索取;要求
pill	n.药丸v.成丸状;抢劫
kick	n.踢;踢球v.踢;反冲
harm	n.损害;邪恶v.损害
recent	adj.全新世的;最近的
snow	n.下雪期;雪v.用雪困住;下雪
fortune	n.富有;好运
strike	n.罢工;打v.打;敲
pretend	v.伪称;装扮
monkey	n.猴v.嘲弄;模仿
insurance	n.保险;保险业
fancy	adj.别致的;特级的n.任性;设想v.相信;想象
drove	n.人群;畜群
car	n.车厢;小汽车
belong	v.合适;属
night	n.黑夜;夜
shape	n.体形;形状v.形成;表规
dog	n.公狗;狗v.跟踪;困扰
base	adj.基础的;卑劣的n.基;基础v.驻扎;作...的基础
lift	n.提;天空v.鼓舞;提
stock	n.砧木;主干;储备v.备货;发肿
fashion	n.方式;上流社会v.改变;制作
freedom	n.直爽;自由
guarantee	n.保证;担保v.担保;确保
chest	n.箱;胸
bridge	n.鼻梁;桥v.架桥于;跨越
source	n.出处;源
patient	adj.忍耐的;有耐心的n.病人;顾客
theory	n.理论;学说
camp	n.兵营;拘留所v.临时安顿;搞同性恋
original	adj.起初的n.原型;原作
juice	n.精;汁v.给...加汁液
burn	n.燃烧;烧伤v.点燃;烧掉
access	n.接近;通道v.存取;接近
watch	n.手表;守卫v.保卫;等待
head	n.上端;头v.长头;发源
selfish	adj.自私的
oil	n.石油;油v.溜;融化
drink	n.喝酒;饮料v.喝
wise	adj.聪明的;了解的v.教导;知道
fail	n.不及格;交割失信v.不;缺乏
period	n.纪;时间
doll	n.俊妞儿;玩偶v.打扮得花枝招展
elevator	n.电梯;起重机
freeze	n.冰冻期;冻结v.冷冻;冻结
noise	n.声音;噪声
exist	v.存在;发生
science	n.科学;科学事物
pair	n.一双;一条v.成对;配合
edge	n.边;刀口v.加边于;使锋利
player	n.演员;运动员
ceremony	n.典礼;礼节
pig	n.猪;陶土v.生;生小猪
peg	n.小钉;桩v.用桩标出;疾行
gun	n.鸣放;炮v.向...开枪;加大油门
vacation	n.假日;休息v.度假
star	n.星;星宿v.用星装饰;当明星
file	n.文件夹;锉刀v.发送;锉
bike	n.巢;群v.骑自行车;蜂拥
weather	n.恶劣天气;天气v.经受风雨;退色
mostly	adv.一般地;主要地
stress	n.压力;应力v.重读;着重
suck	n.吸;吸食v.吸;吸食
permission	n.允许
example	n.范例;例题
borrow	v.借用;借
release	n.发泄;放v.发泄;放出
note	n.按语;短笺v.记录;注意
joy	n.成功;欢欣v.享受;高兴
library	n.书房;图书馆
junior	adj.较年幼的;小n.较年幼者;三年级生
property	n.财产;地产
negative	adj.否定的;禁止的
fabulous	adj.惊人的;寓言的
event	n.结果
door	n.门;门状物
scream	n.尖叫声v.尖叫得使;尖叫着说
vision	n.幻觉;看;视觉
member	n.成员;子句
bone	n.骨;骨质v.施骨肥于;苦学
battle	n.格斗;竞赛v.搏斗;作战
safety	n.安全;无损
term	n.词;期v.把...称为
devil	n.恶棍;魔鬼v.给律师当助手
meal	n.挤奶;进餐
fellow	n.男人;人
apology	n.辩护;道歉
anger	n.怒;痛苦v.使发怒;发怒
honeymoon	n.蜜月假期;新婚之月v.度蜜月
wet	adj.多雨的;湿的n.湿气;雨v.尿湿;变湿
bail	n.保释;戽斗v.保释;托付
park	n.公园;狩猎区v.停放;停放车辆
protection	n.保护;保护者
manager	n.当家人;经理
fix	n.方位;困境v.定居;固定
dawn	n.开端;黎明v.开始;破晓
sport	n.玩笑;游戏;运动v.夸示;浪费
campaign	n.运动;战役v.参加运动;作战
map	n.地图;图v.勘测;被安置
wash	n.洗;洗东西处v.洗;洗去
sensitive	adj.敏感的;易波动的
steal	n.偷盗v.偷盗;偷垒
photo	adj.照片的n.照片v.为...拍照
let	n.出租;租户v.使;允许
comfort	n.安慰;盖被v.安慰;帮助
worry	n.担心;撕咬v.撕咬;担心
whom	pron.谁;他
pocket	n.一袋;钱袋v.把...围住;皱起
bleed	v.抽干;出血
student	n.学生;学者
shoulder	n.肩;肩部v.担负;肩起
ignore	v.驳回;不顾
talent	n.明星;天才
garage	n.加油站;汽车间v.把...送入汽车间
die	n.板牙;模具v.遭受;死
demon	n.恶魔;恶人
travel	n.旅行;漫游v.经过;旅行
success	n.成功;发迹
dump	n.倾倒;倾销v.倒掉;倾卸
train	n.连串;列车v.把...对准;训练
rude	adj.粗鲁的;简单的
crack	n.裂缝;瑕疵v.砸开;变粗
model	n.模型;原型v.使仿效;做模型
bother	n.烦恼;努力v.打扰;迷惑
radar	n.雷达;雷达技术
willow	n.柳树;威罗机v.用威罗机清理
remain	v.留下;剩余
soft	adj.轻的;柔滑的adv.柔软地;嘘
meantime	adv.在间隔时间里n.间隔时间
connect	v.联系;连接
chase	n.打猎;槽v.赶出;追寻
kind	adj.和蔼的;友好的n.类;种类
cast	n.撒网;投v.投
cancer	n.癌;癌症
sky	n.苍天;天
likely	adj.合适的;可信的adv.很可能
fate	n.命运;天命
hug	n.紧抱;紧搂v.抱有;拥抱
throat	n.嗓音;咽
message	n.启示;信息v.通报
east	adj.东部的;在东方的adv.向东方n.东;东部;东方
unit	n.单位;股份单位
intend	v.想要;意指
crew	n.全体船员;v.当船员
ashamed	adj.惭愧的
midnight	n.半夜十二点钟;漆黑
manage	v.管理;控制
guilt	n.内疚;罪
weapon	n.武器;袭击器官
terms	n.条件;细则v.接受;妥协
interrupt	n.隔阂;中断v.打断;中止
gut	adj.极其重要的n.肚子;内脏v.抢劫
tongue	n.舌;语言
distance	n.进展;远v.使远离;远远超过
conference	n.会议;讨论
treatment	n.处理;对待
shoe	n.蹄铁;鞋
basement	n.地下室;墙根
sentence	n.句子;命题v.使遭受;宣判
purse	n.钱包;资金v.使缩拢;
cabin	n.房舱;棚屋
universe	n.世界;星系;宇宙
towards	prep.对;向
repeat	n.复写;重复v.复述;重复
mirror	n.镜;镜子v.反射;反映
tall	adj.长的;高的
reaction	n.反应;看法
odd	adj.奇数的;单只的;古怪的
engagement	n.订婚;约会
therapy	n.理疗;疗法
letter	n.信;字母v.在...上刻字
emotional	adj.动感情的;感情的
run	n.跑步;赛跑v.跑;逃
magazine	n.弹药库;杂志
decision	n.决定;决议
soup	n.汤;马
thrill	n.颤动;兴奋;害怕v.刺穿;颤动
society	n.阶层;社会
sue	v.控告;请求
stake	n.桩;赌本v.资助;打赌
chef	n.厨师长
move	n.搬家;动v.动;调动
genius	n.特征;天才
extreme	adj.极大的;极端的n.极度;极端
entire	adj.单一的;全部的
nasty	adj.龌龊的
moment	n.片刻;时机
expensive	adj.昂贵的;滥花钱的
count	n.计算;数数v.数;值
square	adj.成直角的;正方形的adv.成正方形;成直角n.方格;广场v.符合;结清
clean	adj.纯洁的;清洁的adv.干净地;完全地v.剥光;被打扫
shift	n.班;变向v.变;替换
plate	n.盘状物;盆子v.覆镀
impress	n.特征;压印v.传送;印
smell	n.气味;嗅觉v.感觉到;嗅
male	adj.男的;雄的n.男子;雄性动物
tour	n.旅行;巡视v.在...旅行;旅行
knock	n.一击;指责v.敲;敲
charm	n.美貌;魅力v.使高兴;行魔法
attractive	adj.有吸引力的
argue	v.争论;争吵
put	v.放;出发
whip	n.鞭打;鞭伤v.鞭打;驱使
language	n.全部词汇;语言
embarrass	v.妨碍;使窘
package	n.包裹;包装袋v.包裹;包装
animal	n.动物;畜
disease	n.病;病害
bust	n.前胸;胸像v.爆裂;破产
stair	n.楼梯;梯级
alarm	n.惊恐;警报v.打扰;使惊恐
pure	adj.纯粹的;纯净的
nail	n.钉子;纳尔v.钉;截住
nerve	n.神经;神经质v.使有劲
hill	n.小山;斜坡
walk	n.行走路程;走v.走遍;走
lane	n.车道;小路
dirt	n.泥土;污物
bond	n.镣铐;约束v.为...作保;黏合
stamp	n.标志;印v.被捣碎;跺脚
friendly	adj.朋友的;友善的adv.友好地
easily	adv.容易地;无疑
damn	adv.该死n.丝毫;咒骂v.使失败;咒骂
job	n.工作;职业
suffer	v.经受;忍受
disgust	n.厌恶;作呕v.使厌恶;使作呕
deliver	v.交出;投递
help	n.帮助;补救办法v.帮助;助
federal	adj.联邦的;联合的n.联邦制拥护者
disaster	n.灾难
bar	n.条;闩prep.除...外v.关;闩
cross	adj.交叉的;相互的adv.横跨地n.十字架v.穿过;交叉
rate	n.比率;费率v.呵责;骂走
create	v.创建;创造
trap	n.牢笼;圈套v.从事诱捕;替...装饰
claim	n.权利;要求v.要求;主张
talk	n.讲话;闲话v.讲;谈论
egg	n.蛋;人v.向...扔蛋;鼓励
effect	n.感受;结果v.产生;使发生
chick	n.小孩;小鸡
turkey	n.土耳其;失败之作;吐绶鸡
threaten	v.警告;威胁
snake	n.奸险的人;蛇v.拖曳;蛇行
introduce	v.插入;介绍
rescue	n.强行夺回;营救v.营救;逃叫
confession	n.承认;忏悔
embarrass	v.妨碍;使窘
bag	n.袋;猎袋v.猎获;收割
lover	n.爱人;情夫
impression	n.压印;印象
gate	n.大门;路v.给...装门;用门控制
fantasy	n.幻想作品;想象v.想象;奏幻想曲
reputation	n.好名声;名气
ball	n.球;舞会v.交媾;狂欢
attack	n.攻击;侵蚀v.攻击
among	prep.被...所环绕;系...中之一
knowledge	n.熟悉;知识
present	adj.出席的;现在的n.现在;礼物v.表示;提出
inn	n.宿舍;小酒店
chat	n.鸣禽;闲谈v.劝告;闲谈
suffer	v.经受;忍受
argument	n.理由;说理
crowd	n.群;群众v.挨;挤
homework	n.家庭作业
cancel	v.抵消;取消
accept	v.承认;接受
rip	n.裂口;偷窃v.划破;撕
pride	n.骄傲;自豪v.使得意;自豪
solve	v.解;解决
hopeful	adj.有希望的n.有希望的青年
pound	n.磅;镑v.捣碎;剧跳
pine	n.凤梨;松木v.痛苦;消瘦
mate	n.偶;配偶v.使交配;交配
illegal	adj.不合法的
generous	adj.大的;慷慨的
street	n.街;街区
director	n.导演;董事
glen	n.峡谷
con	n.骗局v.熟读;骗
separate	adj.不同的;分开的v.分割;分隔
outfit	n.全套服装;一队人v.装备;获得装备
maid	n.处女;少女
bath	n.浴;浴水
punch	n.力量;一拳v.挥击;冲
mayor	n.市长
freak	adj.反常的n.畸形;主意突变v.扰乱;胡闹
recall	n.返回通知;回想v.记得;叫回
enjoy	v.经历;享有
bug	n.病菌;虫子v.烦扰;突出
prepare	v.准备
part	n.一部分;组成部分v.放弃;分开
wheel	n.轮;轮状物v.旋转;转弯
signal	n.标志;导因v.是...的标志;发信号
direction	n.管理;指示
defend	v.防御;防守
sign	n.标志;符号v.签;写下
painful	adj.困难的;疼痛的
wall	n.壁;墙v.给...建墙;转动
rat	n.耗子;鼠v.偷;捕鼠
amount	n.量;总数v.等同;合计
suspicious	adj.猜疑的
heart	n.内心;心
flat	adj.瘪的;平的adv.平直地;完全地n.平面;一层
cook	n.厨子;蒸煮v.烹调;烧
button	n.按钮;钮扣v.圆满完成;装钮扣于
warn	v.警告;通知
sixty	n.第六十;六十
pity	n.可惜;同情v.同情;有同情心
crisis	n.关头;危机
coach	n.活动房屋;旅客车厢v.训练;当教练
row	n.路;一排v.划;划运
baseball	n.棒球;棒球运动
yell	n.叫喊;呐喊v.向...叫喊;叫喊
lead	n.指引;铅v.牵;致使
awhile	adv.片刻
pen	n.笔;圈v.起草;写
confidence	n.信任;信心
offer	n.发价;给予v.给予;提出
fall	n.降落;落下v.砍倒;跌倒
image	n.外形;像v.想象;造像
farm	n.农场;饲养场v.耕作;种植
panic	n.恐慌;小米v.使大笑;使恐慌
hers	pron.她的
smith	n.创造者;锻工;工匠
role	n.角色;作用
refuse	n.废料v.拒不;拒绝
grandpa	n.爷爷
progress	n.进步;前进v.改进;前进
testify	v.表明;声明
pass	n.境况;通过v.超过;经过
military	adj.军人的;军事的n.军人;武装部队
choice	adj.上等的;中上级的n.选择;选择时机
artist	n.能手;艺术家
gym	n.体操馆;体育
cruel	adj.残忍的;严格的
wing	n.翅;翅膀v.飞过;飞
traffic	n.交通;运输v.在...上通行;交易
pink	adj.粉红色的;眯着的n.石竹;微光v.刺;刺痛
mental	adj.精神的;颏的
gentleman	n.先生
coma	n.怠惰;昏迷
poison	n.毒物v.给...服毒药;放毒
guest	n.客;旅客
expert	adj.熟练的n.特等射手;专家
bull	adj.大号的;雄的n.公牛;玺v.彻底打扫;闲聊
benefit	n.义演;益处v.有益于;得益
bell	n.钟;钟声v.鸣钟;吼叫
face	n.表面;脸v.面朝;朝
case	n.框;箱v.探察
ghost	n.鬼;灵魂v.代...作文;当捉刀人
jump	n.跳;心神不安v.使跳;跳
toilet	n.便池;厕所v.上盥洗室;梳妆
secretary	n.秘书;书记
sneak	adj.偷偷的;突然的n.告密生v.偷窃;偷偷地做
mix	n.混合;混合物v.拌成;和入
firm	adj.坚定的;坚固的n.工作小组;商号v.确认;变硬
agreement	n.达成协议;协定
privacy	n.秘密;隐退
date	n.日期;时期v.过期;注有日期
remind	v.说...以提醒;提醒
pot	n.罐;坑v.饮酒;用便盆
twin	adj.孪生的n.双子座v.怀;孪生
swing	n.摆程;摆动v.挥舞;摆动
successful	adj.成功的;有成就的
season	n.季;节期v.给...调味;变干燥
scream	n.尖叫声v.尖叫得使;尖叫着说
consider	v.考虑;认为
solid	adj.固体的;牢固的adv.肯定;全部地n.固体;固形物
option	n.选择;选择权
flash	n.闪光;闪亮v.闪;飞驰
commitment	n.交押;托付;诺言
senior	adj.较年长的;老n.较年长者;四年级生
ill	adj.不利的;坏的n.病;坏
crush	n.极度拥挤;压碎v.挤;碾碎
ambulance	n.救护车
wallet	n.工具袋;资金;皮夹
discover	v.发现;显露
official	adj.公职的;正式的n.官员;行政人员
gang	n.一帮;路v.聚集成群;行走
rise	n.岗;上涨v.登上;离席
reach	n.地带;伸出v.到达;伸出
eleven	n.第十一;十一
option	n.选择;选择权
laundry	n.洗衣店;赃东西
former	adj.前任的;以前的
assure	v.弄清楚;使确信
stay	n.逗留;停止v.停止;延迟
skip	n.蹦跳;跳进v.跳;跳越
hunt	n.打猎;猎区v.追猎;摆动
fail	n.不及格;交割失信v.不;缺乏
wide	adj.宽的;宽松的adv.广大地;全部地
challenge	n.怀疑;挑战v.向...挑战;提出挑战
popular	adj.民众的
learn	v.发现;学
discussion	n.论述;讨论
clinic	n.门诊部;专科医院
plant	n.秧苗;植物v.插;种
exchange	n.交换;交火v.换;交换
betray	v.背叛;泄露
stick	n.棍;木条v.刺;停留
university	n.大学;大学人员
target	n.靶;目标v.规定...的指标
member	n.成员;子句
lower	v.放下;减低low的比较级
bored	adj.令人厌烦的
mansion	n.大厦;领主宅第
soda	n.钠;苏打
silver	n.钱;银v.镀银于;变成银色
sheriff	n.名誉郡长;县治安官
suite	n.房间;家具
bust	n.前胸;胸像v.爆裂;破产
senator	n.参议员;理事
load	n.负荷;思想负担v.装;装货
study	n.学科;学习;研究v.记住;学习;研究
procedure	n.常规;程序
ocean	n.海洋;海
section	n.部分;乐器组v.将...切片;被切成片
winter	n.冬;寒冷天气v.过冬
commit	v.把...托付给;犯
bone	n.骨;骨质v.施骨肥于;苦学
assignment	n.分配;任务
suicide	n.自杀;自杀者v.自杀
spread	n.翼展;展开v.撒;涂
mind	n.头脑;智力v.记住;照料
fish	n.鱼;鱼肉v.捕;捕鱼
swim	n.漂浮;眩晕v.浸;漂浮
end	n.端;终止v.结束;胜过
bat	n.短棍;球棒;蝙蝠v.行进;眨
yell	n.叫喊;呐喊v.向...叫喊;叫喊
league	n.盟约;同盟
seat	n.坐部;座v.供给...座位;使坐下
proper	adj.本来的;适宜的
holiday	n.假期;假日
command	n.命令;指挥v.俯临;命令
believe	v.认为;想
hope	n.希望v.希望;相信
fifth	n.第五;第五日
solution	n.解;解决
leader	n.领先者;领袖
yellow	adj.发黄的;黄的n.黄;黄色颜料v.使发黄;发黄
sharp	adj.锋利的;尖的
sale	n.卖;销路
lawyer	n.律师
giant	n.巨人;水枪
nor	adv.也不
material	adj.身体上的;物质的n.布;材料
latest	n.最新款式
ash	n.灰灰2;撒灰于
high	adj.高的;高地的adv.高;高价的n.高地;高峰
audience	n.读者;观众
winner	n.获胜者
parent	n.父亲;祖先v.做...的父亲
burn	n.燃烧;烧伤v.点燃;烧掉
trick	n.诡计;技巧v.打扮;哄骗
insist	v.坚持;被放置
cheer	n.欢呼;心情v.对...欢呼;欢呼
flesh	n.肥胖;肉v.长肉
district	n.地区;区v.把...划分成区
wood	n.木;木材
routine	adj.例行的;一般的n.固定节目;例行公事
century	n.一百分;百人
sandwich	n.三明治v.插入
hand	n.脚;手v.搀扶;交
false	adj.不诚实的;不正确的
beat	adj.筋疲力尽的n.跳动v.打;拍打
appear	v.出现;露面
adult	adj.成年的;成熟的n.成年人
warrant	n.授权;搜查证v.授权给;向...保证
spike	n.大钉;穗v.摔球触地
garden	n.公园;花园v.用花园点缀
awful	adj.使人畏惧的adv.十分
odds	n.机会;投注赔率
article	n.契约;条款;物品;冠词v.列举;进行控告
treat	n.款待;乐事v.对待;看待
thin	adj.薄的;稀薄的;瘦的v.使薄;变薄
suggest	v.建议;意思是
fever	n.发热;热病
female	adj.雌的;女的n.雌性动物;女子
sweat	n.出汗;汗v.分泌;出汗
silent	adj.安静的;不作声的
specific	adj.明确的;特有的n.特效药;特性
clever	adj.机敏的;灵巧的
sweater	n.发汗剂;针织套衫
request	n.需要;要求v.要求
prize	n.奖赏;撬v.估价;撬
mall	n.分隔带;林荫路
mile	n.英里
estate	n.地产
diamond	n.金刚石;钻石
union	n.联合;连接
judgment	n.判断;审判
goodnight	n.晚安
quality	n.品德;性质
despite	prep.不管
sure	adj.可靠的;确信的adv.当然;无疑
step	n.步;步态v.跨;踩
jet	n.喷嘴;煤玉v.喷出;喷射
confess	v.坦白;忏悔
mountain	n.山;山脉
math	n.割;马思
listen	v.听;听从
answer	n.答案;反应v.回应;回击
vulnerable	adj.易受伤的;敏感的
bless	v.使神圣;为...祝福
dream	n.出神;梦v.做;想
room	n.房间;一套房间v.占一房间
chip	n.薄片;缺口;碎片v.削下;镌刻
zero	n.零;零点v.接近
potential	adj.潜在的;势的n.潜力;潜在性
piss	n.尿;啤酒v.尿;排
kill	n.击落;杀死v.冻死;杀死
grant	n.给予;授予物v.承认;授予
wolf	n.狼;狼皮v.取笑;猎狼
tear	n.悲痛;撕v.流泪;撕
knee	n.膝部;膝关节v.向...下跪
chill	n.风寒;寒冷v.变冷;激冷
blonde	n.白肤金发碧眼女人
brain	n.脑;脑袋v.重击...的头
agency	n.代理行
degree	n.程度;度
unusual	adj.与众不同的
joint	adj.共有的;接合的n.关节;接合
rob	v.盗窃;抢
pack	n.包;小包v.挤;洗
dream	n.出神;梦v.做;想
cure	n.药;治疗v.消除;治愈
cover	n.书壳;掩蔽v.盖;代替
newspaper	n.报社;报纸
coast	n.海岸;滑行v.绕...而行;滑行
grave	adj.暗淡的;低沉的n.墓碑;墓穴
egg	n.蛋;人v.向...扔蛋;鼓励
direct	adj.笔直的;直接的adv.径直地v.管理;指示
cheat	n.骗子;欺骗v.哄骗;欺骗
break	n.破裂;破晓v.打破;破坏
quarter	n.四分之一;一刻钟
orange	adj.橙黄色的;柑橘的n.橙;橙树
mix	n.混合;混合物v.拌成;和入
locker	n.锁柜;箱
gift	n.礼物;赠送
brand	n.烙铁;商标v.打烙印于;加商标于
awkward	adj.笨拙的;不雅观的
toy	n.玩具v.调情;玩弄
rare	adj.稀薄的;稀有的adv.很v.渴望
policy	n.方针;计谋
reasonable	adj.公平的;正当的
dozen	n.打;许多
curse	n.灾祸;诅咒v.使遭难;诅咒
million	n.百万;许多
dessert	n.水果;甜食
rolling	adj.滚的;起伏的
detail	n.细部;细节v.列举;详述
alien	adj.外国的n.外国人;外侨v.使疏远;转让
delicious	adj.美味的;有趣的
vampire	n.吸血鬼
ancient	adj.古代的;古老的n.古钱;旗帜
value	n.价格;价值v.夸耀;尊重
tail	n.辫子;尾v.使长尾巴;尾随
site	n.地方;地皮v.给...择址;设置
secure	adj.安全的;安心的v.保证;缚牢
salad	n.色拉;生菜
murderer	n.谋杀犯
hit	n.击;碰撞v.打;碰撞
spit	n.吐;岬v.喷;捅
screen	n.屏;纱窗v.放映;遮
pilot	n.驾驶员;向导v.驾驶;为...引航
penny	n.便士;分
dust	n.地面;粉v.擦去;沾上灰
conscience	n.良心;意识
bread	n.面包;食物
answer	n.答案;反应v.回应;回击
lame	adj.金银锦缎;跛的n.老古板;薄板v.使跛;变跛
invitation	n.吸引;邀请
grief	n.悲伤;不幸
path	n.道路;路
destiny	n.命运;天数
stand	n.停住;站立v.经受;容忍
bowl	n.碗;木球v.得...分
pregnancy	n.充盈;怀孕
prisoner	n.犯人;刑事被告
delivery	n.讲话;交出;传送
guard	n.警戒;警卫员v.保守;看守
desire	n.要求;愿望v.渴望;要求
virus	n.病毒;毒素
shrink	n.缩水;退缩v.不愿;收缩
influence	n.势力;影响v.影响
concert	n.和声;一致;音乐会v.商议;协力
wreck	n.残骸;沉船v.破坏;损害
partner	n.搭档;伙伴v.使合伙;合伙
chain	n.枷锁;链v.束缚
bird	n.鸟;幼鸟
wire	n.电线;金属丝v.打电报给;打电报
technical	adj.技术的
presence	n.出席;进见
anxious	adj.焦虑的
cave	n.酒窖;地窖v.塌落;当心
version	n.变化形式;译本;说法
holiday	n.假期;假日
clear	adj.纯色的;清晰的adv.离开着;完全v.扫清;变晴
car	n.车厢;小汽车
candle	n.堪;蜡烛
charm	n.美貌;魅力v.使高兴;行魔法
apple	n.苹果
pulse	n.脉搏;意向;豆子v.使搏动;搏动
jump	n.跳;心神不安v.使跳;跳
joke	n.笑话v.取笑;说笑话
frame	n.车架;构架v.构筑;制订
boom	n.暴涨;吊杆v.使繁荣;暴涨
vice	adj.代替的n.邪恶;淫乱
occasion	n.时机;时刻v.引起
silence	n.寂静;静默v.使安静;压制
opera	n.歌剧;歌剧院
opal	n.蛋白石
nonsense	n.胡说
frighten	v.使惊恐
downtown	adj.商业区的n.较低地区;商业区
internet	n.因特网
holly	n.冬青树枝
duck	n.鸭;野鸭v.躲避;忽地低下
blow	n.吹;花v.吹;吹响
session	n.会议;开庭
actual	adj.实际的;现行的
spin	n.疾驰;旋转v.纺;吐
classic	adj.仿古希腊;标准的;一流的n.文豪;文学名著
civil	adj.公民的;国内的
tool	n.工具v.驾驶;驱车旅行
pack	n.包;小包v.挤;洗
education	n.教育;教育学
wrap	n.毯子;外衣v.包;覆盖
obsess	v.困扰;迷住
fruit	n.果实;水果v.使结果实;结果实
torture	n.拷打;歪曲v.拷打;歪曲
location	n.定位;位置
loan	n.贷款;暂借v.错出;贷款
effort	n.努力;全部努力
commander	n.海军中校;指挥官
tree	n.木制用具;树v.在...上植树;爬上树
rock	n.大石;矿石v.轻摇使;轻摆
owner	n.船长;物主
fairy	n.仙人;众仙子
bank	n.岸;堆v.开银行;做庄家
network	n.网状物;织物v.用网覆盖
per	prep.按照;每
county	n.郡;县
contest	n.竞赛;争夺v.竞赛
chuck	n.轻击;扔v.放弃;扔
seventy	n.第七十;七十
print	n.印刷;印刷品v.打上;印
motel	n.汽车旅馆
direct	adj.笔直的;直接的adv.径直地v.管理;指示
underwear	n.衬衣
gram	n.克;祖母
exhaust	n.废气;排出v.用完;排出气体
particular	adj.特定的;特殊的n.详情;一项
freak	adj.反常的n.畸形;主意突变v.扰乱;胡闹
careful	adj.关切的;精确的
trace	n.痕迹;迹v.查出;走
touch	n.触;触觉v.触摸;触摸
mess	n.凌乱状态v.把...弄脏;玩弄
committee	n.促进会;委员会
smooth	adj.光溜的;磨平的v.弄平;铺平
recovery	n.恢复;收回
intention	n.意思;意图
enter	v.参加;登记
belt	n.带;腰带v.飞驶;猛击
standard	adj.标准的;普通的n.标准
sacrifice	n.祭品;献祭v.牺牲;献祭
courage	n.勇敢
butter	n.奉承;黄油v.涂黄油于...
officer	n.船长;法警
enjoy	v.经历;享有
ad	n.作广告
lack	n.缺乏;需要v.短少;缺乏
buck	adj.雄的adv.完全地n.鹿皮;男人v.顶撞;反抗
attract	v.偷窃;吸引
appear	v.出现;露面
bay	adj.枣红色的n.湾;坝v.对...吠叫;大声叫嚷
yard	n.码;庭院;场地
return	n.回;送回v.回报;回
remove	v.调动;脱下
nut	n.干果;核心
testimony	n.记述;声明
intense	adj.紧张的;强烈的
grant	n.给予;授予物v.承认;授予
violence	n.暴力;猛劲
heal	v.调停;愈合
defend	v.防御;防守
attempt	n.攻击;企图v.企图;引诱
unfair	adj.不公正的;不正当的
political	adj.国家的;政党的
loyal	adj.忠诚的;忠心的
approach	n.进路;近似v.近似;靠近
slow	adj.耗时的;慢的adv.慢慢地v.放慢;放慢速度
play	n.比赛;玩v.开;玩
normal	adj.平常的;正常的n.师范学校;正常人
buzz	n.谣言;吱吱声v.说闲话
alcohol	n.醇;酒糖;酒精
actor	n.行动者;演员
surprise	n.惊奇;突然袭击v.撞见;惊奇
plain	adj.单色的;朴素的n.平原;平针
attic	n.顶楼
uniform	adj.均匀的n.制服
son	n.儿子;女婿
pet	n.得宠的人;不高兴v.抚摸;生气
clean	adj.纯洁的;清洁的adv.干净地;完全地v.剥光;被打扫
threaten	v.警告;威胁
teach	v.教;教导
mum	adj.无言的n.沉默;妈妈v.化装作乐
motion	n.动;提议v.摆动;做手势
desert	n.荒漠;沙漠v.背离;抛弃
collection	n.募捐;收集
incident	n.伴随的事;事件
failure	n.缺乏;失败
hook	n.钩;陷阱v.钓;钩
headache	n.头痛
act	n.幕;行为v.扮演;演
opposite	adj.对面的;反对的adv.在对面n.对边;对立物prep.在...的对面
gross	adj.恶劣的;总的n.罗;总额v.赚得总收入
golden	adj.含金的;金的
equipment	n.才能;配备
badge	n.标记;徽章
tennis	n.网球运动
visit	n.参观;视察v.访问;视察
studio	n.画室;音乐教室;射影棚
natural	adj.有关自然的n.智力低下的人
sake	n.理由;目的
labor	n.工作;劳动v.劳动;努力
glory	n.光荣;赞颂v.吹嘘;骄傲
trunk	n.躯干;树干
arm	n.臂;军种v.提供;武装起来
twist	n.转弯v.捻;转动
thousand	n.第一千;一千
received	adj.被普遍接受的
costume	adj.与服装匹配的n.成套服装;戏装v.为...提供服装
temporary	adj.短暂的;暂时的n.临时雇员
sixteen	n.第十六;十六
impressive	adj.威严的
zone	n.地带;地区v.将...分成区;分成区
kitty	n.猫咪;小猫
kick	n.踢;踢球v.踢;反冲
unlike	adj.不等同的;不相似的prep.不像的
understand	v.得知;理解
mercy	n.慈悲;宽大处理
describe	v.画出;描写
priest	n.祭司;司铎
client	n.顾客;委托人
cable	n.缆绳;锚链v.系缚;装上缆索
own	adj.自己的n.属于自己的东西v.承认;有
affect	n.内心倾向;自觉感情v.打动;侵袭
instinct	adj.充满着的n.本能;天资
discuss	v.论述;品尝
stranger	n.陌生人;生手strange的比较级
lead	n.指引;铅v.牵;致使
host	n.主人;军队v.招待;群集
authority	n.当局;权
cow	n.母牛;牛v.吓唬;截短
commercial	adj.商品的;商业的n.商业广告;宣传
admire	v.称赞;钦佩
shadow	n.阴影;影子v.钉...的梢;渐变
question	n.难题;问题v.怀疑;问
fund	n.储备;存款v.积累
barn	n.谷仓;靶
object	n.对象;物体v.提出;反对
deep	adj.深的;有...深的adv.强烈地;深深地n.海;海渊
amp	n.截肢;安培
tense	adj.紧的;紧张的n.时v.使拉紧;拉紧
sport	n.玩笑;游戏;运动v.夸示;浪费
route	n.路;途径v.为...安排路线
report	n.报道;报告v.报道;说
plastic	adj.可塑的;塑料的n.塑料;塑料学
hop	n.毒品;忽布v.飞越;跳过
election	n.当选;选举
pierce	v.穿入;刺入
mortal	adj.人的;死的adv.极n.人;生物
stop	n.停止;阻塞v.停止;阻塞
abandon	n.放任;狂放v.放弃;离弃
side	n.边;旁边v.同意;赞助
deliver	v.交出;投递
become	v.适合;变成
agenda	n.行为事项
hunt	n.打猎;猎区v.追猎;摆动
series	n.连续;系列演出
literally	adv.简直;确实地
propose	v.提;提出
basketball	n.篮球;篮球运动
underneath	adv.在里面;在下部prep.在...下面
force	n.力;武力v.强迫;逼叫
soldier	n.军事家;士兵
service	n.服务v.检修;为...服务
sauce	n.沙司;炖水果v.给...调味
review	n.复习;回顾v.复习;细察
promise	n.可能;允诺v.向...保证;允诺
oz	n.盎司
lecture	n.讲稿;训斥v.给...讲课;训斥
eighty	n.八十;第八十
brandy	n.白兰地;刺激物
bill	n.清单;帐单v.爱抚;接吻
window	n.窗;窗框
shock	n.冲击;震动v.使震惊;震扰
relief	n.缓解;救济
horse	n.马;骑兵v.发情;上马
golf	n.高尔夫球运动v.打高尔夫球
explain	v.讲解;解释
counter	n.筹码;柜台v.反对;还击
design	n.设计;图案v.决意;谋划
circle	n.环状物;圆v.绕过;围着
victim	n.牺牲;牺牲者
transfer	n.调动;迁移v.搬;调动
response	n.反应;回答
channel	n.沟渠;海峡v.输送;在...开槽
backup	n.背衬;候补者;倒车
identity	n.身份;同一
different	adj.差异的;各别的
campus	n.大学;大学校园
spy	n.间谍;密探v.看见;侦察出
ninety	n.第九十;九十
interest	n.利益;趣味v.使参与;使感兴趣
guide	n.导游;向导v.操纵;给...领路
deck	n.甲板;桥面v.击倒;装饰
biological	adj.生物的;生物学的
minor	adj.不严重的;较小的n.未成年人;小企业v.副修
ease	n.安适;容易v.放松;解除
creep	n.爬行;蠕动v.爬行
waitress	n.女侍者
skill	n.技术;熟练性
telephone	n.电话;电话机v.打电话
photo	adj.照片的n.照片v.为...拍照
scratch	adj.侥幸的n.微伤;抓v.抓;搔
ring	n.戒指;金环v.发;鸣
print	n.印刷;印刷品v.打上;印
flower	n.花;精华v.发育;开花
wave	n.波;高潮;挥手;浪v.招手;波动;飘摇
royal	adj.国王的;敕立的n.顶桅帆;王裁
law	n.法律;法制
figure	n.价格;数字v.计算;出现
ask	v.问
writer	n.执笔者;作者
reception	n.接待;接受
pin	n.饰针;销子v.按住;别住
annoy	v.打搅;使恼怒
agent	n.代理人;动源
goal	n.目标;球门
council	n.会议;理事会
mass	n.弥撒;弥撒曲;团v.集中;聚集
ability	n.能力;能耐
sergeant	n.军士
blast	n.吹奏;鼓风;疾风v.炸;开枪
basic	adj.基础的;碱的n.基本训练;基本原理
wing	n.翅;翅膀v.飞过;飞
tradition	n.传统;口传;惯例
towel	n.毛巾v.打;用毛巾擦
earn	v.获得;应得
clown	n.乡下人;小丑v.扮小丑
rub	n.擦;摩擦v.擦;揉擦
habit	n.气质;习惯
customer	n.顾客
creature	n.人;生物
count	n.计算;数数v.数;值
action	n.行动;行为
snap	adj.迅速的;摁扣的n.厉声;劈啪声v.发吧嗒声;喀嚓折断
react	v.使起反应;影响
prime	adj.青春的;首要的n.春;青春v.加注;装填
pace	n.步;步速v.步测;踱步于
comment	n.批评;闲话v.评论;注释
tax	n.负担;税v.对...收会费;对...征税
sink	n.落水洞;污水井v.下沉;下落
reporter	n.报告人;记者
nurse	n.保姆;护士v.调养;当保姆
beat	adj.筋疲力尽的n.跳动v.打;拍打
priority	n.优先;在先
interrupt	n.隔阂;中断v.打断;中止
gain	n.获得;增加v.获得;增加
warehouse	n.仓库;批发店v.以他人名义买进
virgin	adj.处女的;纯洁的n.处女;童男
shy	adj.迟疑的;怕陌生的n.惊退;尝试v.后退;惊退
pattern	n.模范;样品v.仿制;与...相等
loyalty	n.忠诚
inspector	n.检查员;巡官
event	n.结果
candle	n.堪;蜡烛
pleasant	adj.活泼的
media	n.中脉;浊塞音medium的复数
excuse	n.藉口;歉意v.为...辩解;原谅
duke	n.公爵;双手
castle	n.藏身所;城堡v.王车易位
threat	n.威胁;凶兆
permanent	adj.耐久的;永久的
guess	n.猜测v.猜;想
financial	adj.财政的
demand	n.需要;要求v.强要;询问
basket	n.篮;篮状物
assault	n.攻击;强奸v.攻击;困扰
tend	v.照顾;期待
pray	adv.请v.祈望;做
train	n.连串;列车v.把...对准;训练
museum	n.博物馆;收藏物
alley	n.球道;小径
track	n.轨道;小道v.跟踪;走过
range	n.级别;排;山脉v.排列;变动
nap	n.小睡;绒毛v.小睡;浇
mysterious	adj.神秘的
unhappy	adj.不恰当的;不幸的
tone	n.音;语气v.增强;调和
switch	n.长假发;一击v.鞭打;挥动
liberty	n.释放;许可
bang	adv.砰;砰然n.轰声;巨响v.奔;猛击
award	n.奖;判决v.判给;授予
load	n.负荷;思想负担v.装;装货
gut	adj.极其重要的n.肚子;内脏v.抢劫
childhood	n.童年;早期
sample	n.实例;样本v.品尝;浏览
piss	n.尿;啤酒v.尿;排
hundred	n.第一百;一百
balance	n.平衡轮;天平v.称;权衡
background	n.底子;后景
toss	n.猛举;扔v.扔;甩
mob	n.暴民;群氓v.成群围住;成群袭击
misery	n.疼痛;痛苦
central	adj.为首的;中心的
boot	n.靴;罩v.猛踢;逐出
thief	n.贼
squeeze	n.紧握;榨v.紧握;榨
potter	n.陶工v.闲混;闲逛
lobby	n.穿堂;议院走廊v.游说
exercise	n.履行;运动v.履行;训练
ego	n.自我;自我中心
drama	n.戏;戏剧艺术
patience	n.坚忍;忍耐
noble	adj.高尚的;光辉的n.工贼头目;贵族
forth	adv.往外;向前
engine	n.机车;机械
book	n.卷;书v.预订;预订
song	n.歌;诗歌
poker	n.戳的人;妖精;纸牌戏
eighteen	n.第十八;丁八
bury	v.埋葬;掩埋
perform	v.履行;做
everyday	adj.每天的
wonder	n.惊奇;奇迹v.感到惊讶;感到疑惑
trail	n.痕迹;尾部v.飘;拖
saint	n.圣徒v.正式封...为圣徒
rotten	adj.发臭的;腐烂的
liver	n.肝;肝脏
device	n.手段;装置
village	n.居民村;乡村
march	n.3月n.行军;边界v.进展;前进
journey	n.历程;旅行v.在...旅行;旅行
fit	adj.健康的;适合的n.合身;配合v.配合;适合
discuss	v.论述;品尝
zombie	n.蛇神;蟒神
supply	n.供应;供应量v.供给;弥补
moral	adj.道德的;有道德的n.典型
helpful	adj.建设性的
attach	v.系;附属
slut	n.荡妇;女郎
search	n.检查;搜查v.探;细察
depress	v.按下;使抑郁
alien	adj.外国的n.外国人;外侨v.使疏远;转让
aisle	n.通道;侧廊
pro	n.公关人员adv.从正面n.赞成的论点prep.在...之前;赞成
daughter	n.女儿;女性后裔
vow	n.誓;郑重宣告v.立誓奉献;发誓
proposal	n.求婚;提出
pit	n.坑;核v.使有坑;小停
darn	n.织补;织补处v.织补
clay	n.泥土;黏土
cent	n.百;分
arrange	v.安排;整理
use	n.用;用途v.发挥;用
useless	adj.差劲的;无益的
squad	n.班;小队v.把...编成班;指派...到班
represent	v.代表;使有代表
product	n.产品;产物
join	n.并;连接v.连接;参加
afterwards	adv.以后
adventure	n.冒险;生意v.拿...冒险;冒险
resist	v.抵抗;抗
protect	v.保护
net	n.网;网罗v.捕获;织网
fourteen	n.十四
piano	adj.降低的;轻的adv.降低地;轻轻地n.钢琴
inch	n.身材;英寸v.缓慢地移动
flag	n.旗;小旗v.变慢;变弱
debt	n.欠款;义务
darkness	n.黑暗;无知
violent	adj.暴力的;狂热的
tag	n.标签;挂襻v.标示;添加
sand	n.沙;沙滩v.撒沙于;沙淤
gum	n.树胶;龈v.粘合;讲话
strip	n.条v.剥去;脱去
hip	adj.时髦派的n.基节;臀v.使知悉;使沮丧
below	adv.在楼下;在下面prep.低于;在...下面
remind	v.说...以提醒;提醒
palace	n.豪华住宅;王宫
claim	n.权利;要求v.要求;主张
replace	v.代替;更换
phone	n.受话器;音子
paperwork	n.书面工作;书面作业
mighty	adj.巨大的;强大的adv.很
emotion	n.动;情感
typical	adj.典型的;特有的
stubborn	adj.顽固的;顽强的
stable	adj.固定的;坚定的n.厩;牛棚v.把...拴进厩
pound	n.磅;镑v.捣碎;剧跳
pillow	n.枕头;轴枕v.把...枕在;枕着头
papa	n.爸爸;丈夫
mature	adj.慎重的;熟的v.使成熟;到期
lap	n.耳垂;舐v.嵌接;舔
design	n.设计;图案v.决意;谋划
current	adj.流动的;通行的n.电流;流
bum	adj.假的;劣质的n.差劲者;屁股v.乞求;寄食
tension	n.紧张;拉紧v.使拉紧
tank	n.池塘;箱v.击败;大量喝酒
suffer	v.经受;忍受
stroke	n.敲;一次v.划去;敲击
steady	adj.惯常的;稳的adv.把定;预备n.固定支架;情侣v.使稳;变稳
provide	v.供给;规定
overnight	adj.一整夜的adv.一下子
meanwhile	n.同时
chip	n.薄片;缺口;碎片v.削下;镌刻
beef	n.菜牛;牛肉v.击倒;养
win	n.胜利;赢得物v.赢得;成功
suit	n.套;衣服v.适合;合适
carol	n.欢乐的歌;颂歌v.欢乐地唱;赞美
salt	n.盐;盐状物v.撒盐于...上;以盐喂
express	adj.明确的;专门的adv.特意地;用快递n.捷运公司;快车v.表示
collect	v.取;收
tragedy	n.悲剧;悲剧理论
therefore	adv.因此
spoil	n.目的物;战利品v.宠坏;损坏
realm	n.界;王国
profile	n.侧面;轮廓v.描...的轮廓;写...的传略
degree	n.程度;度
wipe	n.擦;毛巾v.擦;揍
surgeon	n.军医;外科医师
stretch	n.舒展;延伸v.拉直;舒展
nephew	n.后裔;侄子
neat	adj.匀整的;整洁的
fox	n.狐;狐皮v.欺骗;变酸
confident	adj.确信的;有信心的
victory	n.成功;胜利
designer	n.谋划者;设计者
climb	n.爬升;攀登v.攀登;爬
angel	n.安琪儿;天使
title	n.标题;一种v.给...加标题;授予...称号
suggest	v.建议;意思是
punishment	n.罚
hint	n.暗示;建议v.暗示;作暗示
furniture	n.帆具;家
blanket	n.床毯;盖毯v.通用于;掩盖
twist	n.转弯v.捻;转动
trigger	n.扳机;起动装置v.发动;触发
surround	v.包围;围住
surface	n.表面;地面v.使公开化;变得清醒
proceed	v.进而做;进行
lip	n.唇状物;嘴唇
niece	n.侄女
handy	adj.手边的;手巧的;便利的
glove	n.棒球手套;手套v.给...手套
soap	n.钱;皂v.贿赂;缩小
signature	n.识别标志;署名
disappoint	v.失信于;使破灭
crawl	n.爬;爬泳v.责备;爬
convict	adj.悔罪的n.斑马;已决犯v.证明...有罪
zoo	n.动物园;核粒子园
result	n.获胜;结果v.发生;结果
page	n.记录;页v.翻阅;侍侯
flip	adj.无礼的n.急动;空翻v.捻掷;翻
counsel	n.律师;协商v.劝告;交换意见
cheer	n.欢呼;心情v.对...欢呼;欢呼
doubt	n.迟疑;怀疑v.怀疑;迟疑
crime	n.犯罪;罪
remember	v.记得;牢记
phase	n.面;相位v.使定相;分阶段进行
kit	n.工具包;小猫
halfway	adj.不彻底的;中途的adv.到一半;几乎
bother	n.烦恼;努力v.打扰;迷惑
useful	adj.有用的
madam	n.夫人;女士
jean	n.牛仔裤
gather	v.收集;积聚
cowboy	n.放牛娃;牧牛工
concern	n.公司;关心v.涉及;使挂念
camera	n.暗箱;照相机
blackmail	n.敲诈v.敲诈;胁迫
symptom	n.征候;症状
rope	n.粗绳;绞索v.用绳捆;成绳状
ordinary	adj.平常的;平庸的n.常任法官;寻常
concept	n.发明;概念
cigarette	n.香烟
barb	n.倒钩;非洲马v.在...装倒钩;刈
memorial	adj.记忆的n.记录;纪念物
explosion	n.爆炸
woo	v.招致;争取
trauma	n.精神创伤;外伤
furious	adj.狂暴的;狂怒的
cheat	n.骗子;欺骗v.哄骗;欺骗
avoid	v.避开;避免
thick	adj.厚的;密的n.傻瓜
board	n.板;纸板v.使搭伙;搭伙
approve	v.批准;赞成
urgent	adj.催逼的;紧迫的
minister	n.部长;公使v.敷;供给
drawer	n.抽屉;制图员
sin	n.过错;罪v.犯;犯过失
join	n.并;连接v.连接;参加
jam	n.困境;拥挤v.堵住;压碎
interfere	v.妨碍;介入
governor	n.长官;州长
chapter	n.章;重要章节
catch	n.捕获物;抓v.接住;抓住
bargain	n.交易;协定v.用...交换;讲价
tragic	adj.悲惨的;悲剧的
school	n.上学;学校v.教育;控制
respond	v.应答;作答
punish	v.罚;贪婪地吃
penthouse	n.单斜顶棚;屋顶房间
hop	n.毒品;忽布v.飞越;跳过
angle	n.角;角度v.获取;钓鱼
sherry	n.雪利酒
remain	v.留下;剩余
insult	n.攻击;损伤v.损害;攻击
bug	n.病菌;虫子v.烦扰;突出
beside	prep.和...相比;在...旁边
absolute	adj.纯粹的;道地的n.绝对;绝对事物
strict	adj.完全的;严格的
sock	n.短袜;套子v.储;打
sense	n.感官;感觉v.检测;了解
up	prep.往...的上端;往...的上游
sneak	adj.偷偷的;突然的n.告密生v.偷窃;偷偷地做
worthy	adj.有价值的;值得的n.知名人士
reward	n.报答;酬金v.报答;酬谢
polite	adj.有教养的;有礼貌的
check	n.停止;制服v.核对;击退
tale	n.陈述;故事
physically	adv.身体上;完全地
fool	n.蠢人;弄臣v.愚弄;玩弄
blow	n.吹;花v.吹;吹响
internal	adj.内的;内服的n.本质;精神
bitter	adj.有苦味的n.苦;苦味
adorable	adj.可爱的
test	n.化验;试验v.化验;考验
suggestion	n.暗示;建议
string	n.串;牵线v.缚;开球
mouse	n.姑娘;鼠
mark	n.马可福音;马可n.短线;符号v.标明;评分
debate	n.辩论;辩论会v.辩论;考虑
alike	adj.同样的adv.一样地
pitch	n.投;投球v.投;支搭
jack	n.老兄;男人v.提高;用篝灯猎
fax	n.传真机;事实v.传真传输
distract	v.使混乱;转移
shelter	n.掩蔽;遮盖物v.掩蔽;躲避
lover	n.爱人;情夫
lesson	n.功课;教程
goose	n.雌鹅;鹅v.发动
foreign	adj.对外的;外国的
escort	n.护航部队;护卫队v.护送
average	adj.平均的;中等的n.平均分数;平均数v.平均做;平均为
twin	adj.孪生的n.双子座v.怀;孪生
test	n.化验;试验v.化验;考验
constable	n.警察;警官
circus	n.杂技场;马戏团
audition	n.面试;听;试唱v.试演
tune	n.曲调v.调音;合调
shoulder	n.肩;肩部v.担负;肩起
mud	n.干泥地;泥
mask	n.面具;罩v.伪装;掩饰
helpless	adj.无助的;无助益的
feed	n.饲料;喂食v.维持;喂
explain	v.讲解;解释
suck	n.吸;吸食v.吸;吸食
robbery	n.抢劫;抢劫罪
objection	n.不喜欢;反对
behave	v.表现;运转
valuable	adj.贵重的;有价值的n.贵重物品
shadow	n.阴影;影子v.钉...的梢;渐变
creative	adj.产生的;创造的
beast	n.动物;畜生
tub	n.木盆;桶v.给...洗盆浴;洗盆浴
talent	n.明星;天才
customer	n.顾客
bizarre	adj.奇形怪状的n.怪异花
scar	n.疤;痕v.在...上结疤;结疤
punk	adj.糟糕的n.火绒;废话
hold	n.拿;船舱v.表现;掌着
focus	n.焦点;焦距v.集中;聚焦
alert	adj.活泼的;警觉的n.警报;警戒v.使认识到;向...报警
activity	n.活动;行动
stick	n.棍;木条v.刺;停留
singer	n.鸣禽;诗人
reverend	adj.教士的;可尊敬的n.大人;教士
highway	n.公路;捷径
foolish	adj.发窘的;荒谬的
compliment	n.敬意;问候v.赞美;称赞
bless	v.使神圣;为...祝福
bastard	adj.私生的;野种的n.劣等货;杂种
attend	v.出席;侍候
scheme	n.计划;系统v.计划;密谋
aid	n.帮助;外援v.帮助
worker	n.工人;工作者
wheelchair	n.轮椅
protective	adj.保护的
poetry	n.诗;诗的特征
gentle	adj.轻柔的;温和的
script	n.笔迹;书写体v.为...写剧本
reverse	n.反面;逆转v.反向;逆叫
picnic	n.郊游野餐v.去野餐
knee	n.膝部;膝关节v.向...下跪
intend	v.想要;意指
cage	n.牢房;笼子v.击...入门得分
voice	n.禽鸣声;说话声v.给...整音;说
toe	n.脚趾;足尖部
stink	n.恶臭;化学v.发出恶臭;惹人讨厌
scare	n.惊吓;恐慌v.吓;吓走
pour	v.倒;倾泻
effect	n.感受;结果v.产生;使发生
cheat	n.骗子;欺骗v.哄骗;欺骗
tower	n.堡垒;塔v.高飞;高耸
slide	n.滑道;滑行v.打滑;滑行
ruin	n.毁灭;破产v.毁坏;毁灭
recent	adj.全新世的;最近的
fill	n.充分;装填物v.挤满;装满
exit	n.出口;出去v.离开;出去
cruise	n.航行;旅行v.航行;漫游
cottage	n.别墅;小屋
corporate	adj.全体的;社团的
cat	n.家伙;猫
upside	n.上侧;上面
prove	v.表现;证明
park	n.公园;狩猎区v.停放;停放车辆
instance	n.例子;情况v.举...为例;举例
diary	n.日记;日记簿
complain	v.抱怨;抗议
basis	n.基础;主要部分
politics	n.政治;政治事务
confess	v.坦白;忏悔
wicked	adj.坏的;淘气的
pipe	n.管子;烟斗v.吹奏;发尖声
merely	adv.纯粹地;仅仅
massage	n.按摩;性交v.奉承;修改
color	n.颜色v.变色;脸红
chop	n.砍击;杀死v.砍;剁
budget	n.包;批v.规划;编预算
brief	adj.短暂的;距离短的n.辩护状;概要v.作...的提要
spill	n.溢出;裂片v.摔下;溢出
prayer	n.祷告;祷文
cost	n.代价;价钱v.价钱为;使付出
chick	n.小孩;小鸡
betray	v.背叛;泄露
begin	v.开始
waiter	n.侍者;堂倌
sucker	n.吮吸者;吸血鬼;吸盘v.欺骗
rat	n.耗子;鼠v.偷;捕鼠
fraud	n.骗子;欺骗
flu	n.流行性感冒
brush	n.刷;刷状物v.刷;推
adopt	v.采取;继承
table	n.一桌酒菜;桌子v.把...列表
sympathy	n.吊慰;同情
pill	n.药丸v.成丸状;抢劫
lean	adj.贫瘠的;瘦的n.倾斜;瘦肉v.屈身;斜
filthy	adj.肮脏的;卑劣的
cliff	n.悬崖
web	n.网;织物
seventeen	n.第十七;十七
land	n.地产;陆地v.靠岸;落下
expression	n.表达;表示
entrance	n.进入;入口v.使狂喜
employee	n.女受雇者;受雇者
draw	n.被拉的量;拉v.拔出;拉
cap	n.便帽;根冠v.覆盖;给...带帽
bunny	n.松鼠;兔子
bracelet	n.手铐;手镯
thirteen	n.第十三;十三
scout	n.侦察员;侦察者v.搜索;侦察
principal	adj.主震的;资本的n.为首的人;主要演员
pay	n.报偿;付钱v.付;付款
fair	adj.公正的adv.公正地;正面地n.美;女人
facility	n.容易;设备;技能
arrive	v.抵达;出生
unique	adj.罕有的;唯一的
track	n.轨道;小道v.跟踪;走过
spite	n.不幸;恶意v.恶意对待
shed	n.棚屋;榭v.抗;分散
recommend	v.劝告;推荐
nanny	n.保姆
naive	adj.天真的;幼稚的
menu	n.菜单;饭菜
grade	n.等级;阶段v.把...筑平;递变
diet	n.国会;会议v.进食
corn	n.谷粒;鸡眼
rose	n.玫瑰;玫瑰色;玫瑰香水
patch	n.臂章;补钉v.补缀;拼制
grey	adj.灰色的n.灰色;坯布v.成为灰色
dime	n.一角钱;小钱
tap	n.轻拍;酒v.轻拍;放出;开发
subtle	adj.微妙的;细微的
include	v.包括;包住
garrison	n.堡垒;要塞v.镇守
citizen	n.公民;平民
bullet	n.枪弹;小圆球
bean	n.豆;嘴峰v.击...的头部
pile	n.一堆;桩v.把...堆积;拥
metal	n.金属;金属制品
executive	n.行政部门;执行者adj.有办事能力的
confirm	v.巩固;证实
capital	adj.首都的;重要的n.首都;资本
adult	adj.成年的;成熟的n.成年人
toe	n.脚趾;足尖部
string	n.串;牵线v.缚;开球
parade	n.队列;游行v.集合;游行
bow	n.弓;虹v.弯曲;鞠躬
borrow	v.借用;借
booth	n.售货棚;投票站
toy	n.玩具v.调情;玩弄
straighten	v.整理;变直
steak	n.牛排;鱼块
status	n.地位;法律地位
remote	adj.边远的;远的
poem	n.诗
plant	n.秧苗;植物v.插;种
honor	n.名誉;荣誉v.使增光;尊敬
youth	n.青年时期;青年人
exam	n.考试
daily	adj.每日的;一天的adv.每日n.女佣;日报
convenient	adj.近处的;省力的
travel	n.旅行;漫游v.经过;旅行
lay	adj.世俗的;外行的n.层;歌曲v.置放;产卵
insist	v.坚持;被放置
crystal	n.晶粒;水晶
apply	v.涂;应用
unit	n.单位;股份单位
technology	n.技术;术语
steel	n.钢;钢条v.给...包上钢;用刀戳
muscle	n.肌肉;瘦肉v.使劲挤出;使劲行进
dish	n.碟;一盘菜v.挫败;闲谈
sale	n.卖;销路
legend	n.传说;民间传说
kindly	adj.仁慈的;温和的adv.仁慈地;衷心地
grandson	n.孙子
donor	n.供血者;赠送人
wheel	n.轮;轮状物v.旋转;转弯
temper	n.性情;脾气v.回火;缓和
teenager	n.青少年
strategy	n.策略;战略
mother	n.继母;母v.生;产生醋母
monitor	n.班长;告诫者v.监测;监控
iron	n.铁;熨斗v.熨;熨衣
house	n.房屋;棚v.覆盖;住
eternity	n.不朽;永恒
denial	n.否认;拒绝承认
couple	adj.两个n.夫妻;一对v.联想;连接
backwards	adv.往回;向后
tent	n.帐篷;帷幕v.观察;注意
swell	adj.极好的;时髦的n.膨胀;凸出v.隆起;膨胀
noon	n.午夜;正午
episode	n.插曲;一个事件
drive	n.驾驶;紧迫v.逼迫;赶
bacon	n.熏咸肉;赃物
spirit	n.精神;灵魂v.鼓励;偷偷地走
potion	n.饮剂;饮料
hole	n.巢穴;洞v.打;打洞
fence	n.防护装置;栅栏v.防护;拦开
dial	n.表盘;刻度盘v.拨;救
affair	n.事;事情
act	n.幕;行为v.扮演;演
whatsoever	pron.无论什么
ward	n.病房;牢房;区v.守护;抵挡
rehearsal	n.复述;排练
nuclear	adj.核的;核心的;核能的
leather	n.皮带;皮革
hostage	n.人质
hammer	n.锤子;小锤子v.强使;敲打
discover	v.发现;显露
constant	adj.不断的;忠实的n.常数;常项
bench	n.长凳;法官席v.给...以席位;当法官
taxi	n.出租汽车
shove	n.推v.强使;推
set	n.集子;一套v.放;落
limit	n.范围;限度v.限定;限制
impress	n.特征;压印v.传送;印
gray	n.戈瑞
connect	v.联系;连接
needle	n.针;指针v.刺激;穿刺
limit	n.范围;限度v.限定;限制
lad	n.家伙;男孩
instant	adj.紧急的;立即的n.时刻;瞬息
form	n.模型;形体v.构成;形成
disagree	v.不一致;争论
tiger	n.虎;强悍的人
stink	n.恶臭;化学v.发出恶臭;惹人讨厌
recover	v.恢复;追回
loser	n.输者;遗失者
groom	n.马夫;新郎v.照料;打扮
gesture	n.手势;姿态v.做手势
develop	v.发展
constant	adj.不断的;忠实的n.常数;常项
block	n.大块;街区v.堵塞;阻碍
tunnel	n.地沟;石巷;隧道v.掘;掘隧道
suspect	adj.可疑的n.被怀疑的人v.怀疑;疑有
seal	n.封蜡;印记v.保证;盖章于
paradise	n.乐园;天堂
legal	adj.法律的;合法的
illness	n.病;恶意
hear	v.听;听见
aye	adv.明白;是n.肯定的回答
vehicle	n.传播媒介;交通工具
teacher	n.教员
sheet	n.薄片;被单
receive	v.得到;收到
psychic	adj.精神的;通灵的n.通灵的人;心理叫牌
teenage	adj.十几岁的
rabbit	n.兔;兔的毛皮
puppy	n.小狗;幼小动物
knock	n.一击;指责v.敲;敲
behalf	n.利益
accidental	adj.非主要的;意外的n.临时记号;突出光线
ton	n.公吨;吨
superior	adj.较大的;较高的n.上级;占优势者
slack	adj.松的;松闲的n.松弛;松闲v.放松;减缓
seek	v.试图;去
manner	n.方式;态度
homeless	adj.无家的
hollow	adj.凹的;空的n.凹陷处;山谷v.使成中空;变空
hill	n.小山;斜坡
desperate	adj.绝望的
critical	adj.批评的
coward	n.胆小的马;胆小鬼
theme	n.题目;主题
tape	n.彩带;带子v.用狭带装订
sheet	n.薄片;被单
personnel	n.人事部门;人员
item	n.警告;条
gear	n.齿轮;工具v.啮合;适应
majesty	n.陛下;雄伟
forest	n.林区;一丛
fan	n.螺旋桨;扇子v.扇
ton	n.公吨;吨
spell	n.符咒;魔力v.拼作;拼字
producer	n.发生器;生产者
launch	n.下水;汽艇v.发射;开始
instinct	adj.充满着的n.本能;天资
extreme	adj.极大的;极端的n.极度;极端
belief	n.相信;信念
quote	n.牌价;引号v.报;引用
motorcycle	n.摩托车v.骑摩托车
appeal	n.呼吁;上诉v.控告;呼吁
advance	adj.先行的;预先的n.前进v.促进;提出
fashion	n.方式;上流社会v.改变;制作
empire	n.大企业;帝国
aid	n.帮助;外援v.帮助
accomplish	v.达到;实现
grip	n.紧握;握力v.连接;握紧
bump	n.肿块;重击v.猛击;碰
soldier	n.军事家;士兵
production	n.产品;产生
need	aux.须要n.缺少;需要v.缺少;需要
invisible	adj.非贸易的;看不见的
complex	adj.复合的;复杂的n.情结;体系
compare	v.把...比作;比较
cloud	n.一大群;云v.覆盖;弄暗
champion	adj.极好的n.斗争者v.捍卫;向...挑战
bother	n.烦恼;努力v.打扰;迷惑
blank	adj.空白的;空的n.空白v.除去;消失
treasure	n.金银财主;珍品v.储存;铭记
tooth	n.口味;牙v.给...装齿;相咬
territory	n.地区;领土
sacred	adj.宗教的
inner	adj.精神的;内部的
earn	v.获得;应得
compromise	n.居间之物;妥协v.连累;泄露
cocktail	adj.鸡尾酒会的n.合成物;鸡尾酒
tramp	n.步行;流浪v.步行;踏
sign	n.标志;符号v.签;写下
messenger	n.送信人;先驱
land	n.地产;陆地v.靠岸;落下
intimate	adj.个人的;熟悉的n.至交v.暗示;宣布
dignity	n.官阶;庄严
soul	n.精神;灵魂
root	n.底部;根v.生根;搜寻
inform	v.通知;告发
god	n.上帝n.男神;神
dress	n.衣服;装饰v.布置;穿衣
cigarette	n.香烟
bless	v.使神圣;为...祝福
billion	n.十亿;大量
upper	adj.北部的;较高的n.上铺;鞋帮
manner	n.方式;态度
lightning	n.闪电
leak	n.漏;漏洞v.使渗漏;漏
fond	adj.喜爱的
seduce	v.说服;唆使
player	n.演员;运动员
operate	v.操作;经营
modern	adj.近代的;现代化的n.近代
liquor	n.酒;液
butter	n.奉承;黄油v.涂黄油于...
stuff	n.料子;物品v.填没;饱食
emotional	adj.动感情的;感情的
division	n.分;分配
condition	n.健康状况;状况v.使健康;训练
transplant	n.移植;移植器官v.移植;迁移
tip	n.末梢;芽尖v.倾倒;翻倒
powder	n.粉;药粉v.搽粉;逃跑
oxygen	n.氧
nicely	adv.谨慎地;恰好地
lunatic	adj.精神错乱的n.狂人
drill	n.操练;钻头v.刺穿;钻除
design	n.设计;图案v.决意;谋划
complain	v.抱怨;抗议
visitor	n.参观者;访问者
slap	adv.恰好地;直接地n.打击;掴v.涂抹;掴
pumpkin	n.南瓜;西葫芦
prayer	n.祷告;祷文
plug	n.塞子;填料v.苦干;枪击
open	adj.开着的;空旷的n.旷野;露天v.开;开辟
oath	n.誓言;咒骂
mutual	adj.共同的;亲密的
hockey	n.精液;屎
graduate	n.量筒
confirm	v.巩固;证实
broad	adj.广泛的;宽的
yacht	n.冰上滑艇;快艇v.驾快艇
spa	n.矿泉;游览胜地
remember	v.记得;牢记
horn	n.角;角质v.用角抵触;装角于
bait	n.打尖;饵v.引诱;装饵于
appearance	n.出版;出现
abuse	n.弊病;滥用v.滥用;虐待
stare	n.惊恐;凝视v.凝视;倒竖
safe	adj.安全的;谨慎的n.保险箱;家用冰箱
reunion	n.团聚;再联合
plot	n.平面图;情节v.用坐标定;密谋
burst	n.爆发;爆炸v.爆发;爆炸
aha	adv.啊哈
experiment	n.实验v.进行实验
dive	n.扑;跳水v.探究;扑去
commission	n.授权;委任状v.委任;委托制作
chaos	n.混乱;混沌
cell	n.蜂房巢室;小牢房;细胞;电池
aboard	prep.在...上
return	n.回;送回v.回报;回
lesbian	adj.女同性恋的n.女同性恋者
expose	n.暴露;阐述v.暴露;使处于
trust	n.信任;信心v.想;信任
spider	n.星形轮;蜘蛛
mountain	n.山;山脉
booze	v.饮酒n.酒
tattoo	n.纹身;归营号v.刺
sweep	n.扫;扫荡v.扫;扫去
sore	adj.悲伤的;痛的n.痛处
proper	adj.本来的;适宜的
parole	adj.假释的n.假释;口令v.假释
effective	adj.生效的
ditch	n.沟;海v.开沟;逃学
decide	v.解决;决定
cancel	v.抵消;取消
bra	n.奶罩
speak	v.讲;说
rubber	n.橡胶;橡皮
reach	n.地带;伸出v.到达;伸出
glow	n.光亮;灼热v.发红;洋溢
foundation	n.底座;地基
wear	n.穿;服装v.穿着;蓄
thirsty	adj.干旱的;渴的
skull	n.颅骨;脑袋
scotch	n.格线;刻痕v.伤害;镇压
ring	n.戒指;金环v.发;鸣
dorm	n.宿舍
din	n.喧嚣v.再三叮嘱;发渲闹声
bend	n.弯曲;绑结v.挽;俯身
unexpected	adj.没有料到的
system	n.系统;制度
sob	n.畜生;呜咽v.哭得使;呜咽
pat	adj.好的adv.熟记地n.轻拍;小块v.轻拍;轻轻地走
pancake	n.薄煎饼;湿粉饼v.使平展;平伸
harsh	adj.刺目的;苦涩的
flatter	v.胜过;谄媚flat的比较级
existence	n.存在;发生
trouble	n.烦恼;困难v.麻烦;折磨
fight	n.战斗;争吵v.打;奋斗
eat	v.吃;咬
computer	n.计算机;计算器
chin	n.聊天;颏v.与...谈话;聊天;振作起来
bravo	n.喝彩声;打手v.向...喝彩
seal	n.封蜡;印记v.保证;盖章于
rage	n.狂暴;狂怒v.发怒;狂吹
cause	n.理由;事业v.使;使产生
bubble	n.冒泡;泡v.激动;冒泡
border	n.边;边界v.邻接;接界
undercover	adj.暗中进行的n.从事秘密工作的特工人员
spoil	n.目的物;战利品v.宠坏;损坏
shine	n.光;光泽v.擦亮;照耀
rug	n.小地毯
identify	v.认出;认同
destroy	v.打破;破坏
deputy	adj.代理的n.代表;副职
deliberate	adj.故意的;审慎的v.商议;仔细考虑
conspiracy	n.同谋;阴谋
clothing	n.帆装;衣服
thoughtful	adj.沉思的;注意的
similar	adj.相似的;相像的
plate	n.盘状物;盆子v.覆镀
nail	n.钉子;纳尔v.钉;截住
miracle	n.奇迹;奇事
investment	n.授权;投入
fridge	n.冰箱
contrary	adj.对方的;逆向的adv.相反地n.反面;相反
beloved	adj.受爱戴的;所钟爱的n.心爱的人
wash	n.洗;洗东西处v.洗;洗去
stalk	n.柄;茎v.在...蔓延;蔓延
sack	n.大袋;麻袋v.开除;赢得;洗劫
earl	n.伯爵;郡主
approval	n.批准;赞成
practical	adj.可实施的;实践的
jungle	n.热带植丛
involve	v.卷;需要
industry	n.工业;勤劳
fuel	n.燃料;食物v.激起;加燃料
dancer	n.跳舞者;舞蹈演员
cotton	n.棉;棉树v.娇惯;领会
cook	n.厨子;蒸煮v.烹调;烧
possession	n.拥有;有
point	n.尖;尖形部件v.显示;指
foul	adj.腐烂的;难闻的adv.犯规地n.犯规;碰撞v.弄脏;玷污
editor	n.编辑;编者
dull	adj.隐约的;愚钝的v.减轻;变钝
beneath	adv.在较低处;在下prep.在...底下;在...下方
age	n.成年;年龄v.使老;变陈
peanut	adj.渺小的n.花生;花生米
horror	n.恐怖;恐怖性
heel	n.跟;后跟v.紧跟;倾侧
grass	n.草;草场
deaf	adj.不愿听的;聋的
stunt	n.矮株病;发育不良v.阻止
portrait	n.画;肖像
paint	n.涂漆;颜料v.画;描写
jealousy	n.猜忌;妒忌
hopeless	adj.医治不好的
fear	n.害怕;可能性v.害怕;恐怕
cut	n.切;切口v.切;凿
conclusion	n.结论;结尾
volunteer	adj.志愿的;自生的n.志愿兵;自愿者v.自愿;自愿提供
sword	n.剑;权力象征
scenario	n.电影脚本;设想
satellite	adj.卫星的n.卫星;追随者
necklace	n.项圈
crash	n.碰撞;坠毁v.使坠毁;坠毁
accuse	v.指控
restrain	v.管押;控制
naughty	adj.顽皮的;邪恶的
human	adj.人的;似人类的n.人
homicide	n.杀人;杀人者
helicopter	n.直升机
formal	adj.正式的;克式量的n.礼服;甲缩醛
firing	n.焙烧;烧毁
shortly	adv.简短地;立刻
diamond	n.金刚石;钻石
auction	n.叫牌;拍卖v.叫牌
videotape	n.录像磁带v.把...录在录像磁带上
store	n.储存;大量v.储备;装满
pop	n.爸爸;大伯v.敲击;突然行动
appetite	n.爱好;胃口
vanquish	v.征服
symbol	n.符号;象征
prevent	v.防止;先去
patrol	n.巡逻;巡逻兵v.巡查;巡逻
ironic	adj.冷嘲的;用反语的
flow	v.流出;流
father	n.父;父亲v.生
excitement	n.刺激;激动
anyhow	adv.不管怎样n.随便杂乱无张
tear	n.悲痛;撕v.流泪;撕
send	v.发送;派遣
rape	n.劫掠;强奸v.;强奸
laugh	n.笑;笑柄v.开颜;笑
function	n.功能;官能v.工作;行使职责
core	n.果心;团v.小偷小摸
charm	n.美貌;魅力v.使高兴;行魔法
carpet	n.地毯织料;地毯状物v.训斥
bowl	n.碗;木球v.得...分
belly	n.腹;腹腔v.使鼓起;鼓起
sub	n.潜艇;部下v.编辑;审订
shark	n.鲨;骗子v.诈取;诈骗
dealer	n.发牌者;商人
cooperate	v.合作
bachelor	n.单身男子;学士
accomplish	v.达到;实现
wake	n.守候;守夜v.唤醒;醒
struggle	n.斗争;奋斗v.斗争;奋斗
sort	n.性质;种类v.拣出;符合
fort	n.堡垒;要塞
coke	n.焦;可卡因v.焦化
yard	n.码;庭院;场地
vote	n.票;投票v.公议;建议
taste	n.尝;味v.尝;吃
loft	n.阁楼;厩楼v.吊高;吊高球
intention	n.意思;意图
integrity	n.完善;完整
wish	n.请求;希望v.但愿;祝
towel	n.毛巾v.打;用毛巾擦
suspect	adj.可疑的n.被怀疑的人v.怀疑;疑有
slight	adj.少量的;纤细的n.冷落;轻视v.忽视;看轻
profit	n.利;利益v.得益;获利
log	n.计程仪;原木v.伐木
immediate	adj.立即的;直接的
ginger	n.姜;精力
back	adj.背后的;边远的adv.往回;向后n.背;缸v.使后退;后退
sunset	n.日没;晚霞
pan	n.秤盘;平底锅v.烧;淘
own	adj.自己的n.属于自己的东西v.承认;有
nation	n.国家;国民
lipstick	n.口红
lawn	n.草坪;菌苔
compassion	n.同情
cafeteria	n.自助餐馆
belong	v.合适;属
affect	n.内心倾向;自觉感情v.打动;侵袭
scarf	n.鸬鹚;领巾v.围;吃
precise	adj.精确的;清晰的
obsession	n.着迷;着魔
management	n.管理;管理人员
lose	v.失去;遗失
lighten	v.闪出;照亮
infection	n.传染;影响
explode	v.爆发;爆炸
chemistry	n.化学;化学过程
balcony	n.阳台
storage	n.贮藏;贮藏库
spy	n.间谍;密探v.看见;侦察出
publicity	n.宣传品;名声
exist	v.存在;发生
employee	n.女受雇者;受雇者
depend	v.信赖;依靠
cue	n.暗示;角色v.给...提示;排队
crack	n.裂缝;瑕疵v.砸开;变粗
conscious	n.意识;有意的
ally	n.同盟国;助手v.使结盟;联合
ace	adj.第一流的n.纸牌;发球得分v.打败
account	n.记述;解释v.报帐;导致
absurd	adj.荒诞派的;荒谬的n.荒诞
vicious	adj.邪恶的;恶性的n.恶性循环
tool	n.工具v.驾驶;驱车旅行
strong	adj.极大的;强壮的adv.强烈地;强有力地
rap	n.苛责;罪责;轻敲声v.拿走;抢;轻敲
potato	n.甘薯;破洞
invent	v.发明;捏造
hood	n.风帽;暴徒v.加罩于
forbid	v.不许;阻止
direction	n.管理;指示
defendant	adj.防御的;作辩护的n.被告
bare	adj.赤裸的;光秃的v.揭露;使赤裸
announce	v.声称;宣布
screw	n.螺钉;阳螺旋v.操纵;旋
sample	n.实例;样本v.品尝;浏览
salesman	n.售货员;推销员
round	adj.丰满的;圆的n.圆圈;圆形物prep.围绕;向...各处v.变圆;环行
leap	n.跳;跳跃距离v.使跳;跳
ken	n.视野;窝v.看到;认出
injury	n.伤害;损伤
genetic	adj.创始的;历史上的
freak	adj.反常的n.畸形;主意突变v.扰乱;胡闹
fighter	n.好斗者;战士
document	n.公文;证件v.为引证
burden	n.重担;重负v.加重荷于;加重压于
swallow	n.吞;燕v.吞并;吞没
slave	n.奴隶v.使从属;使做奴隶
reveal	v.揭示;启示
religious	adj.宗教的
kidnap	v.绑架;诱拐
gown	n.宽外袍;女裙服v.穿上宽大的长外衣
enter	v.参加;登记
chair	n.椅子;主席v.使入座
wish	n.请求;希望v.但愿;祝
statue	n.雕像;造型游戏
serial	adj.连续的n.连载小说;期刊
sandy	adj.含沙的;沙土色的
punish	v.罚;贪婪地吃
dramatic	adj.戏剧般的;戏剧的
dismiss	v.解雇;去除
criminal	adj.犯罪的;刑事的n.罪犯
blade	n.前舌;叶片
seventh	n.第七;第七日
regret	n.懊悔;道歉v.痛惜;因...懊悔
rap	n.苛责;罪责;轻敲声v.拿走;抢;轻敲
quarter	n.四分之一;一刻钟
produce	n.产品;成果v.生;生产
lamp	n.灯;光
dentist	n.牙科医生
anyway	adv.随随便便地
anonymous	adj.匿名的;无特色的
add	v.添加;做加法
semester	n.半年;学期
risk	n.危险;危险率v.把...作赌注;冒...的危险
regard	n.关系;敬爱v.敬爱;看待
owe	v.欠;欠钱
magazine	n.弹药库;杂志
machine	n.机动车;机器v.使定型
lung	n.肺;呼吸器官
explain	v.讲解;解释
delicate	adj.柔和的;鲜美的
trick	n.诡计;技巧v.打扮;哄骗
eager	adj.敏锐的;热切的
doom	n.命运;判决v.决定;注定
coffin	n.棺材;蹄槽v.把...装进棺材
click	n.棘爪;吸气音v.进行顺利;完全一致
cafe	n.咖啡;咖啡馆
button	n.按钮;钮扣v.圆满完成;装钮扣于
bureau	n.办事处;局
adoption	n.采取;收养
we	pron.我们;人们
surrender	n.放弃;投降v.放弃;屈服
stone	n.界石;磨石v.向...扔石块;用石铺
stab	n.刺;猛的一击v.刺;刺伤
sickness	n.弊病;恶心
scum	n.浮藻;浮渣v.去除;起泡沫
loop	n.环路;圈v.把...打成环;打环
generation	n.产生;代
floating	adj.浮动的;流动的
envelope	n.包裹物;信封
enter	v.参加;登记
chamber	adj.室内的;私人的n.会议厅;室v.装
casino	n.小别墅;赌场
vault	n.洞穴;拱顶v.成穹状;跳跃
sunshine	n.光明;日光
pretend	v.伪称;装扮
plea	n.借口;恳求
photograph	n.照片v.给...拍照;拍照
petty	adj.气量小的;小的
heal	v.调停;愈合
fiancee	n.未婚妻
cascade	n.小瀑布;一连串v.通过;串联
remarkable	adj.非凡的
random	adj.胡乱的n.任意行动
guitar	n.吉他
frog	n.蹄楔;蛙
cabinet	n.顾问团;内阁
brat	n.顽童;围裙
sixth	n.第六;六分之一
scale	n.翅瓣;鳞;天平;标尺v.剥落;生鳞;攀登
privilege	n.特权;特权授予
pencil	n.笔类物;铅笔v.草拟;用铅笔写
passionate	adj.热情的;易怒的
nerve	n.神经;神经质v.使有劲
lawsuit	n.诉讼
kidney	n.个性;肾
disturb	v.搞乱;扰乱
cross	adj.交叉的;相互的adv.横跨地n.十字架v.穿过;交叉
associate	n.伙伴;准会员v.交往;联合
tire	n.疲劳;服装v.厌倦;打扮
shirt	n.衬衫;贴身衣
post	n.柱;岗位v.宣布;押
oven	n.干燥炉;烤炉
order	n.次序;整齐v.命令;整理
mill	n.磨;磨坊v.磨;碾碎
journal	n.日志;议事录
gallery	n.狭长房间;走廊
delay	n.延迟v.耽搁
club	n.大头棒;球棒v.缴纳;捐献
purple	adj.帝王的;紫的n.梅红;紫色
nest	n.鸟巢;窝v.套叠;筑巢
monster	adj.巨大的n.怪兽;怪物
honorable	adj.诚实的;荣誉的
gene	n.基因
electric	adj.充电的;电的n.带电体;电灯
culture	n.耕作;教养v.耕作;培养adj.文化的
breast	n.胸;胸部v.攀登;以胸撞
breakdown	n.拆除;衰竭;故障
attempt	n.攻击;企图v.企图;引诱
conflict	n.冲突;战斗v.冲突;战斗
bald	adj.明显的;秃头的v.成为秃顶
actress	n.女演员
abandon	n.放任;狂放v.放弃;离弃
wisdom	n.明智;知识
steam	n.力量;水汽v.发出;蒸发
scar	n.疤;痕v.在...上结疤;结疤
pole	n.波兰人n.撑竿;杆v.用杆撑;用篙撑船
collar	n.颈圈;马轭v.强留...谈话
worthless	adj.无价值的
suck	n.吸;吸食v.吸;吸食
standard	adj.标准的;普通的n.标准
resource	n.储备力量;资源
photograph	n.照片v.给...拍照;拍照
graduation	n.毕业;刻度
enormous	adj.反常的;巨大的
disturb	v.搞乱;扰乱
disturb	v.搞乱;扰乱
distract	v.使混乱;转移
deal	n.待遇;交易v.发;分配
conclusion	n.结论;结尾
baker	n.面包师傅;轻便烘炉
vodka	n.伏特加
situation	n.情况;位置
require	v.想要;需要
mid	adj.央元音的;中部的
measure	n.尺寸;量度v.打量;量
crawl	n.爬;爬泳v.责备;爬
congress	n.立法机关;下院
briefcase	n.公事包
whistle	n.吹口哨;口哨v.吹口哨;啭鸣
sit	v.骑;坐
roast	adj.烤过的n.烤v.焙烧;烤
pig	n.猪;陶土v.生;生小猪
massive	adj.粗大的;粗而重的
link	n.环;环节v.串连;挽住
flirt	n.调情者;急动v.倏地扔;调情
exist	v.存在;发生
deposit	n.保证金;沉积物v.存放;放下
bottle	n.奶瓶;一束v.把...装入瓶中
unknown	adj.不知道的n.未知的人;未知元
type	n.类型v.翻印;打字
topic	n.标题;题目
robin	n.旅鸫;知更鸟
riot	n.暴乱;骚乱v.发动暴乱;恣意
minimum	adj.最低的n.极小;最低极限
logical	adj.逻辑的
impact	n.冲击;影响v.充满;冲击
hostile	adj.敌人的;怀敌意的n.敌对分子
embarrass	v.妨碍;使窘
casual	adj.非正式的;偶然的
beacon	n.灯塔;烽火v.照亮
altar	n.圣餐台;圣坛
value	n.价格;价值v.夸耀;尊重
ultimate	adj.基本的;极点的n.终点
skinny	adj.不足的;皮的;皮包骨的
maintain	v.赡养;维持
goods	n.货物;衣料
cover	n.书壳;掩蔽v.盖;代替
battery	n.连续猛击;炮台
survival	n.幸存;幸存者
skirt	n.挡板;裙子v.绕开;位于边缘
shave	n.薄片;剃刀v.剃;修剪
prisoner	n.犯人;刑事被告
porch	n.入口处;走廊
ghost	n.鬼;灵魂v.代...作文;当捉刀人
favor	n.得宠;恩惠v.赐与;喜爱
drop	n.滴;微量v.滴
dizzy	adj.困惑的v.使困惑;使头晕
breast	n.胸;胸部v.攀登;以胸撞
advise	v.建议;劝告
strike	n.罢工;打v.打;敲
raw	adj.生的n.擦伤处
peaceful	adj.和平的;平静的
hooker	n.小偷;老式船
heaven	n.上天;天
fortunate	adj.幸运的
fool	n.蠢人;弄臣v.愚弄;玩弄
draft	n.分遣队;挑选v.起草;挑选
citizen	n.公民;平民
cigar	n.雪茄烟
active	adj.活跃的;积极的n.活跃的人;主动态
weakness	n.爱好;弱点;软弱
ski	n.滑橇;雪板v.在...上滑雪;滑雪
ship	n.船;飞船v.用船运;上船
ranch	n.大牧场;饲养场v.在牧场工作
musical	adj.音乐般的;音乐的
movement	n.动;动作
individual	adj.独特的;个别的n.个人;人
home	adv.在家;在家乡n.家;家庭v.回家;有家
examine	v.查讯;检查
document	n.公文;证件v.为引证
crane	n.水鹤;支架v.起吊;伸长
column	n.支柱;纵队
bribe	n.贿赂v.向...行贿;行贿
beer	n.啤酒;汽水
task	n.工作;任务
species	n.种;种类
sail	n.帆;帆船v.驾驶;漂浮
rum	adj.古怪的;困难的n.酒;朗姆酒
resort	n.常去之地;求助v.前往;求助
rash	adj.鲁莽的adv.鲁莽地n.疹
mar	n.污点v.毁坏
hush	adj.寂静的;秘密的n.寂静;海涛v.使安静;使平静
fuzzy	adj.模糊的;细绒毛的
fragile	adj.脆弱的;纤巧的
forensic	adj.辩论的;法庭的n.辩论练习;辩论学
expense	n.花钱;价钱
difference	n.差别;特点
cow	n.母牛;牛v.吓唬;截短
conduct	n.处理;举止v.表现;处理
comic	adj.滑稽的;喜剧的n.滑稽的人;喜剧性
bell	n.钟;钟声v.鸣钟;吼叫
avenue	n.大街;小路
attack	n.攻击;侵蚀v.攻击
assign	n.受让人v.分配;指定
visitor	n.参观者;访问者
suitcase	n.小提箱
source	n.出处;源
scan	n.细看;眼界v.细看;扫描
rod	n.杆;笞鞭
payment	n.报偿;支付
motor	n.发动机;内燃机v.发动;驾驶汽车
mini	n.迷你裙;微型汽车
insecure	adj.不安全的;不可靠的
gamble	n.赌博;投机v.赌掉;赌博
clerk	n.办事员;售货员v.当售货员
wrist	n.腕;腕部
tube	n.管;管身
starter	n.参赛人;发令员
silk	n.丝;丝织品
pump	n.泵;抽运v.用泵抽吸;操作泵
pale	adj.苍白的;浅的n.尖板条;界限v.使苍白;包围
haul	n.拖v.拖;拖运
guardian	n.看守者;院长
dodge	n.躲闪;托词v.躲避;遮挡
demand	n.需要;要求v.强要;询问
boot	n.靴;罩v.猛踢;逐出
art	n.美术;艺术
thumb	n.第一指;拇指v.用拇指揿
limit	n.范围;限度v.限定;限制
lighter	n.点火器;驳船
elder	adj.过去的n.长者;老年人
connection	n.联系;连接
quiet	adj.安静的;寂静的n.安静;安宁v.确认;使安静
pull	n.拉;拉力v.采;拉
lion	n.名人;狮子
idiot	adj.极愚蠢的n.白痴;傻子
factor	n.系数;因素v.代理经营;做代理商
erase	v.擦掉;消除
deny	v.否认;拒绝给予
cox	v.担任舵手
attack	n.攻击;侵蚀v.攻击
ankle	n.踝
amnesia	n.记忆缺失;健忘症
accept	v.承认;接受
ruby	adj.红宝石色的n.红宝石;红宝石色
hunter	n.猎犬;猎人
heartbeat	n.感情;心搏
fry	n.炒杂碎;鱼苗v.油煎;激动
confront	v.使面对;迎面遇到
back	adj.背后的;边远的adv.往回;向后n.背;缸v.使后退;后退
register	n.登记;登记簿v.登记;指示
phrase	n.短语;话语v.措词;分成短句
operation	n.操作;活动
minus	n.不足;负量prep.减;没有
meet	n.集合;集会v.接;遇见
legitimate	adj.合法的
hurricane	n.风暴;飓风
fix	n.方位;困境v.定居;固定
bucket	n.水桶;桶v.催...拼命跑;用桶提
boat	n.船v.用船装运;乘船
auto	n.汽车
arrogant	adj.傲慢的
tuna	n.金枪鱼;鳗鲡
supper	n.晚餐
sin	n.过错;罪v.犯;犯过失
recipe	n.处方;诀窍;菜谱
pier	n.桥墩;支柱
paternity	n.父亲身份;来源
mason	n.石匠v.在...上砌砖石
lamb	n.羔羊;羔羊皮
genuine	adj.真诚的;真诚
catholic	adj.罗马天主教的n.罗马天主教徒adj.广泛的;宽容的n.扒手
snack	n.快餐;一份;零食v.吃快餐;尖刻地说
rational	adj.理性的n.根据
point	n.尖;尖形部件v.显示;指
passport	n.护照
mind	n.头脑;智力v.记住;照料
guess	n.猜测v.猜;想
fiance	n.未婚夫
display	n.展览;展示v.陈列;炫耀
dip	n.浸;涉猎v.浸;舀取
wedding	n.婚礼;结婚
team	n.队;一组马v.结成一队
report	n.报道;报告v.报道;说
close	adj.紧的;近的adv.接近地n.结束;终止v.关;关
banana	n.香蕉;香蕉味
august	adj.威严的
aspirin	n.阿司匹林
academy	n.私立中学;学院
wig	n.假发;要人v.严斥;恼怒
throughout	adv.到处prep.遍及
spray	n.浪花;喷雾v.喷;向...扫射
pick	n.掏;凿v.掏;凿
occur	v.存在;发生
logic	n.逻辑;推理
knight	n.爵士;骑士v.授...以爵士品位
field	n.场地;田v.接;派...上场
equal	adj.平等的;平均的n.匹敌者;同等的人v.比得上;相等
drown	v.淹没;沉没
contact	n.接触;熟人v.使接触;接触
ritual	adj.礼节性的n.程序;仪式
perfume	n.芳香;气氛v.洒香水于;散发香气
hat	n.贿赂;帽子
ham	adj.业余无线电的n.后腿;火腿v.过火地表演
general	adj.笼统的;全体的n.将军;上将
fusion	n.熔化;熔块
error	n.错误;谬见
elect	adj.精选的n.特权集团v.挑选;选举
dock	n.船坞;港池v.剪短;扣
creature	n.人;生物
vision	n.幻觉;看;视觉
thank	v.感谢;谢谢
thankful	adj.感谢的;欣慰的
sock	n.短袜;套子v.储;打
re	prep.关于;兹就...
nineteen	n.第十九;十九
fork	n.叉;叉状物v.叉起;同时攻
comedy	n.喜剧
analysis	n.分析
throw	n.冒险;投掷v.发射;投
teenager	n.青少年
stress	n.压力;应力v.重读;着重
slice	n.薄刀;薄片v.切;切开
shore	n.滨;陆地
roll	n.小圆面包;一卷v.卷;推
require	v.想要;需要
plead	v.承认;恳求
palm	n.手宽;手掌;棕榈树v.把...硬塞给
ladder	n.梯级;梯子
kick	n.踢;踢球v.踢;反冲
ford	n.可涉水而过之处v.涉过;涉水而过
detective	adj.侦查的;侦探器n.发觉者;侦探
widow	n.寡妇;活寡妇v.使成寡妇;为...守寡
tissue	n.薄纱;一套
shallow	adj.薄的;浅的n.浅水处
repay	v.报答;偿还
reject	n.被拒货品;阻放装置v.拒绝;拒纳
permanent	adj.耐久的;永久的
hack	adj.陈腐的;受雇的n.砍痕;劈v.耙;劈
girlfriend	n.女伴;情人
deadly	adj.极有害的;致死的adv.非常;死一般地
comfort	n.安慰;盖被v.安慰;帮助
ceiling	n.天花板;镶板
bonus	n.红利;奖金
verdict	n.裁定;定论
jar	n.罐子;刺激v.震动;震伤
factory	n.代理商行;制造厂
aim	n.瞄准;目的v.制导;打算
triple	adj.三倍的;三部分的n.三倍数;三垒打v.增至三倍
spill	n.溢出;裂片v.摔下;溢出
respect	n.敬意;尊敬v.关于;敬意
recover	v.恢复;追回
messy	adj.肮脏的;棘手的
interrupt	n.隔阂;中断v.打断;中止
entry	n.登记;进入
blond	adj.白皙的;亚麻色的n.极浅的黄棕色
bleed	v.抽干;出血
benefit	n.义演;益处v.有益于;得益
wardrobe	n.服装部;全部服装;衣柜
objective	adj.客观的;目的的n.宾格;目的
murder	n.谋杀;破坏v.扼杀;谋杀
foster	adj.收养的v.抱有;培养
chart	n.地图;图v.制订...的计划
back	adj.背后的;边远的adv.往回;向后n.背;缸v.使后退;后退
airplane	n.飞机
worker	n.工人;工作者
wave	n.波;高潮;挥手;浪v.招手;波动;飘摇
tie	n.带;领带v.系;打结
soccer	n.英式足球
register	n.登记;登记簿v.登记;指示
multiple	adj.多个的;许多的n.倍数;并联
justify	v.证明...无罪;排整齐
harmless	adj.无恶意的;无害的
fold	n.教会;褶v.交叠;收拢
convention	n.会议;召集
attraction	n.吸引;吸引力
arson	n.放火
whack	n.失灵;重击v.击败;砍
wade	n.浅水处v.跋涉;涉水
tit	n.打击;按钮
salary	n.薪金
residence	n.居住;住处
obligation	n.合同;义务
medium	adj.中间的n.媒质;手段;巫师
develop	v.发展
alliance	n.结盟;盟约
vengeance	n.报复;报复心
severe	adj.尖锐的;严肃的
rack	n.架子;爆裂v.变形;调定
puzzle	n.迷惑;难题v.使复杂;苦思
guidance	n.领导;指导
fire	n.电炉;火v.烧制;发热
courtesy	n.好意;谦恭有礼
caller	n.访问者;呼唤者
bounce	n.吹牛;弹回v.反射;跳
wizard	adj.杰出的;神汉的n.术士;神汉
top	adj.顶的;最高的n.顶;盖v.盖;结束
repair	n.修理;前往v.恢复;去
quiz	n.考查;智力竞赛v.对....考查;戏弄
prep	n.试跑;预备学校v.把...准备好;作准备
involve	v.卷;需要
curiosity	n.好奇;奇物
code	n.编号;编码v.为...编码
circle	n.环状物;圆v.绕过;围着
bear	n.玩具熊;熊v.忍;压
barbecue	n.烤全牲;烤肉v.烤炙;整烤
troop	n.军队;一群v.成群结队;作伴
spinning	n.纺纱;旋转
score	n.得分;分;乐谱v.得;赢得
pursue	v.追赶;追
psychotic	adj.精神病的n.精神病患者
group	n.集体;组v.簇射;形成组
cough	n.咳;咳嗽病v.咳;认罪
claim	n.权利;要求v.要求;主张
accusation	n.指控;控告
share	n.股份;一份v.分开;分享
rush	n.冲;匆忙v.猛推;冲
resent	v.对...表示忿恨
laugh	n.笑;笑柄v.开颜;笑
gather	v.收集;积聚
envy	n.妒忌;恶意v.妒忌;感到妒忌
drown	v.淹没;沉没
chemical	adj.化学的n.化学品
branch	n.分部;树枝v.出枝;分支
sofa	n.沙发
scientist	n.科学家
poster	n.招贴;驿马
model	n.模型;原型v.使仿效;做模型
island	n.岛;岛状物
highness	n.殿下;高
drain	n.排水;排水沟v.消耗;滴干
dock	n.船坞;港池v.剪短;扣
welfare	adj.福利的n.福利;福利救济
theirs	pron.他的;他们的
stall	n.货摊;马厩v.熄火;拖延
spot	n.疤点;点子v.使有污渍;玷污
somewhat	adv.有点
solo	adv.以独力n.独奏曲v.单飞;独唱
realize	v.实现;领悟
jazz	n.爵士乐;爵士舞v.交媾;游荡
hawk	n.掠夺者;鹰v.扑击;翱翔
fool	n.蠢人;弄臣v.愚弄;玩弄
finish	n.结束;抛光v.结束;用完
beard	n.胡须;芒v.公然反对;充当掩护
album	n.唱片套;粘贴簿;相册
unable	adj.不能的;赢弱的
treat	n.款待;乐事v.对待;看待
theatre	n.戏剧界;戏院
succeed	v.接替;成功
stir	n.拨动;活跃v.拨动;惊动
relax	v.放宽
gratitude	n.感激之情
faithful	adj.尽职的;忠实的n.忠实信徒;虔诚徒众
bin	n.帆布袋;容器v.把...放入箱中
accent	n.口音;重音;腔调v.着重
zip	n.拉链;尖啸声;撕裂声v.拉开或扣上拉链
wander	n.漫游;漂移v.漫游;蜿蜒
shell	n.蛋壳;壳v.脱壳;剥去;炮轰
regardless	adv.不顾后果地
locate	v.找到;定居
inevitable	adj.照例必有的
deed	n.事情;行为v.立契转让
crush	n.极度拥挤;压碎v.挤;碾碎
western	adj.向西方的n.西部电影
smell	n.气味;嗅觉v.感觉到;嗅
sheep	n.羊;羊皮革
settlement	n.安顿;移民
rocky	adj.岩石的;摇动的
robe	n.长袍;盖毯v.覆盖;穿上长袍
poet	n.诗人
marked	adj.明显的;有标记的
gossip	n.流言蜚语;闲聊v.作...的教父;闲聊
determine	v.决定;确定
cosmetic	adj.化妆品的;整容的n.化妆品的
cent	n.百;分
accident	n.机遇;意外事情
tricky	adj.难以捉摸的
stiff	adj.绷紧的;硬的adv.僵硬地;完全地n.死尸;醉汉
sincere	adj.不搀假的;诚实的
shield	n.保护物;盾v.保护;庇护
rush	n.冲;匆忙v.猛推;冲
rice	n.稻;米
resume	n.简历;摘要v.恢复;取回
report	n.报道;报告v.报道;说
reference	n.参照;引文出处v.提出...作参考
nightmare	n.梦魇;睡魔
hunch	n.厚片;肉峰;直觉v.使弓起;移
fog	n.模糊;雾v.使困惑;使模糊
firework	n.烟火具;炫示
drown	v.淹没;沉没
crown	n.王冠;王位v.给...戴上;露顶
brass	n.黄铜;黄铜器
accurate	adj.准确的
whisper	n.低语;微量v.低声说出;低语
religion	n.宗教;宗教教育
luggage	n.箱笼;行李
lemon	adj.淡黄色的;柠檬味的n.淡黄色;柠檬
hike	n.长途步行;提高v.拉;提高
explore	v.仔细查阅;勘探
emotion	n.动;情感
dragon	n.龙;凶猛的人
creek	n.小河;小湾
crash	n.碰撞;坠毁v.使坠毁;坠毁
contact	n.接触;熟人v.使接触;接触
cherry	n.樱桃;樱桃红
acid	adj.酸的n.尖刻;酸
shin	n.胫;胫骨v.攀;快步走
roll	n.小圆面包;一卷v.卷;推
righteous	adj.正义的;正直的
goody	n.老妇人;姥姥
frighten	v.使惊恐
festival	adj.节日的n.活动节期;节日
ethics	n.伦理学;行为准则
creep	n.爬行;蠕动v.爬行
camp	n.兵营;拘留所v.临时安顿;搞同性恋
assistance	n.帮助;补助
affection	n.属性;影响
vow	n.誓;郑重宣告v.立誓奉献;发誓
protest	n.抗议;申明v.抗议;申明
lodge	n.旅舍;小屋v.搁住;暂住
haircut	n.发式;理发
eternal	adj.永恒的;永久的n.上帝
essay	n.尝试;论说文
chairman	n.系主任;主席
stud	n.饰钉;饰钮;种马v.使散布;装饰
sailor	n.乘船者;水手
respect	n.敬意;尊敬v.关于;敬意
receipt	n.发票;收到
operator	n.操作员;机务员
include	v.包括;包住
hat	n.贿赂;帽子
goat	n.色鬼;山羊
exclusive	adj.独有的;排斥的n.独家新闻;孤傲的人
define	v.规定;解释
defeat	n.废除;击败v.挫败;击败
cheek	n.边柱;面颊v.无礼地向...讲话
adore	v.崇拜
adopt	v.采取;继承
warrior	n.勇士;战士
track	n.轨道;小道v.跟踪;走过
signal	n.标志;导因v.是...的标志;发信号
shorts	n.短裤
remind	v.说...以提醒;提醒
relative	adj.比较的;相对的n.关系代词;亲戚
pond	n.池塘;海洋
floor	n.层;底v.击败
creation	n.产生;创建
continue	v.继续;延伸
barrel	n.桶;圆筒v.把...装桶;装枪管于
tuck	n.抄网;鼓声v.皱起;塞;击
slight	adj.少量的;纤细的n.冷落;轻视v.忽视;看轻
reporter	n.报告人;记者
rear	adj.后部的;后方的n.后部;后方v.抚养;竖起
press	n.按;压力v.按;挤出
pacific	n.太平洋adj.和解的;宁静的
novel	adj.新的n.小说;新附律
newspaper	n.报社;报纸
madame	n.夫人;鸨母
lick	n.舔;一击v.舔;揍
lazy	adj.懒惰的;慢吞吞的
goddess	n.美人;女神
glorious	adj.光荣的;壮丽的
fiancee	n.未婚妻
candidate	n.候选人;投考者
brick	n.砖;砖块状物v.用砖砌;用砖围住
sane	adj.清醒的;无疾病的
previous	adj.过早的;以前的
kingdom	n.君主身份;王国
kindness	n.仁慈
flame	n.光辉;火焰v.变热;发光
sunny	adj.乐观的;像太阳的
mattress	n.柴排;气垫
lounge	n.起居室;休息厅v.闹逛;倚
lobster	n.龙螯虾;真龙虾
lift	n.提;天空v.鼓舞;提
label	n.标签;称号v.把...称为;使示踪
important	adj.重要的;自负的
glove	n.棒球手套;手套v.给...手套
enterprise	n.办企业;企业单位
cemetery	n.墓地
yell	n.叫喊;呐喊v.向...叫喊;叫喊
spoon	n.匙;傻瓜v.使成匙形;用匙舀
screech	n.尖叫;烈酒v.尖叫
request	n.需要;要求v.要求
plant	n.秧苗;植物v.插;种
nun	n.修女
navy	n.海军;海军部
nail	n.钉子;纳尔v.钉;截住
elephant	n.特大品种;象
annual	adj.每年的n.年报
worm	n.寄生虫病;软体虫v.刺探;潜入
tick	n.虱蝇;蜱v.给...标记号;活动
rest	n.长眠;平静v.长眠;休息
primary	adj.初级的;首要的n.居首位的事物
polish	n.波兰语;波兰人n.擦;光滑v.擦;擦去
monkey	n.猴v.嘲弄;模仿
fuss	n.紧张不安;忙乱v.使烦恼;忙乱
fund	n.储备;存款v.积累
defensive	adj.防守的;防御的n.防御物
compete	v.比赛;竞争
bush	n.灌木;衬套v.用耙耙平;加衬套于
balloon	n.气球;气球形物v.大大增加
sail	n.帆;帆船v.驾驶;漂浮
pocket	n.一袋;钱袋v.把...围住;皱起
depression	n.按下;沮丧;洼地
world	n.世界
indicate	v.标示;表明
appear	v.出现;露面
aggressive	adj.侵犯的
trailer	n.拖车;拖曳者
summer	n.夏;大梁v.夏季放牧;过夏天
slam	n.猛关;满贯v.使劲关;闯
retirement	n.退休;引退
pry	n.窥探;撬杠v.窥探;撬动
narrow	adj.勉强的;狭的n.狭谷;狭窄部分v.变狭;缩小
level	adj.平的;一般高的n.基准面;水平面v.击倒;瞄准
inform	v.通知;告发
fee	n.采邑;费
encourage	v.促进;鼓励
delight	n.高兴;可爱性v.使高兴;感到高兴
daylight	n.光明;日光
currently	adv.流畅地;现时
chew	n.咀嚼;咀嚼物v.嚼;深思
aunt	n.阿姨;伯母
wash	n.洗;洗东西处v.洗;洗去
warden	n.典狱长;监护人;冬梨
toss	n.猛举;扔v.扔;甩
temple	n.教堂;圣堂
permit	n.许可证;鲳鱼v.使放手做;允许
mistress	n.主妇
marrow	n.精华;髓
imply	v.暗指;缠绕
hatred	n.仇恨
grill	n.烤菜餐馆;烤架v.拷问;烤炙
formula	n.表白书;惯例;公式
effort	n.努力;全部努力
corpse	n.残骸;躯体
clue	n.提示词语;线索v.为...提供线索
sober	adj.适度的;未醉的v.使冷静;醒酒
relative	adj.比较的;相对的n.关系代词;亲戚
promotion	n.促进;发起
peel	n.揭片;皮v.剥;脱
offend	v.冒犯;违犯
infect	v.传染;污染
humanity	n.人道;人类
electrical	adj.发生电的
chopper	n.斧头;砍者
cart	n.大车;小车v.手提;赶大车
broadcast	n.广播;撒播v.广播;撒播
suspend	v.悬;悬浮
sting	n.刺;灼痛v.刺;灼痛
glue	n.胶;胶粘物v.紧附;用胶粘
gather	v.收集;积聚
deer	n.动物;鹿
content	adj.高兴的;满意的n.内容;满意v.使满意
combat	n.战斗v.与...战斗;战斗
calendar	n.历法;日历
brutal	adj.严酷的;淫荡的
asset	n.所有物;资产
unpleasant	adj.不和的
tan	adj.棕黄色的;鞣革的n.马戏团;鞣料v.硬化;鞣
robot	n.机器人;自动机
pepper	n.胡椒;辣椒v.向...掷;在...上撒
lease	n.租借;租约v.出租;使分经
killer	n.杀灭物;杀人者
grow	v.种;长
flame	n.光辉;火焰v.变热;发光
domestic	adj.非野生的;家的n.国货;家仆
divine	adj.敬神的;神的n.神;神学的v.发现;推测
depress	v.按下;使抑郁
thrill	n.颤动;兴奋;害怕v.刺穿;颤动
terminal	n.端子;末端adj.晚期的
rib	n.肋骨;肋条v.加肋于;戏弄
offer	n.发价;给予v.给予;提出
flush	adj.充裕的;紧接的adv.齐平地;直接地n.冲洗;急流v.发红;涌
exception	n.除外;异议
earring	n.耳环
deadline	n.截稿线;最后期限
corporal	adj.个人的;躯干的n.下士;圣餐布
update	n.更新;新版v.更新
smack	adv.恰好n.含意;少量v.掴;咂
office	n.办公室;处
melt	n.融化;脾v.融化;溶解
eagle	n.雕;鹰像
actor	n.行动者;演员
trip	n.绊;旅行v.将...绊倒;旅行
tender	adj.嫩的;温柔的n.关怀;交付v.交付;提出
sperm	n.精液;精子
specialist	n.专家;专科医生
scientific	adj.科学的;科学性的
pork	n.政治恩惠;猪肉
plane	n.平面;镘v.飞行;刨
gate	n.大门;路v.给...装门;用门控制
esteem	n.价值;看法v.把...看作;尊重
undo	v.毁坏;开
pray	adv.请v.祈望;做
plague	n.天罚;天灾v.使染瘟疫;使痛苦
manipulate	v.操纵;操作
lance	n.捕鲸矛;长矛v.切开;投
insult	n.攻击;损伤v.损害;攻击
detention	n.拘留;扣留
daisy	n.雏菊;雏菊花
chess	n.国际象棋
adjust	v.调节;解决
wreck	n.残骸;沉船v.破坏;损害
ride	n.骑;骑马道v.骑;乘坐
reminder	n.催单;提示
principle	n.原则;准则
monsieur	n.大亲王;先生
fame	n.传闻;名声
faint	adj.微小的;无力的n.昏厥v.变得微弱;昏厥
confusion	n.困惑;骚乱
cloud	n.一大群;云v.覆盖;弄暗
bake	n.烘;烤餐会v.烘;晒热
illusion	n.错觉;幻想
execution	n.实行;制作
distress	n.贫困;疼痛v.故意磨损;使痛苦
definition	n.定义;解释
cutter	n.切刀;切者;快艇
correct	adj.正当的;正确的v.惩治;改正
complaint	n.抱怨;控告
chicken	adj.胆小的;鸡肉的n.家禽;小鸡v.胆怯
block	n.大块;街区v.堵塞;阻碍
trophy	n.奖杯
structure	n.机构;结构v.建立;建筑
rot	n.腐败;腐烂v.腐败;腐烂
risk	n.危险;危险率v.把...作赌注;冒...的危险
pointless	adj.无尖头的;无意义的
pearl	adj.小颗粒的;珍珠的n.珍珠;珠状物v.采珍珠;成珠状
household	n.王室;一家人
heir	n.继承人;子孙v.继承
hand	n.脚;手v.搀扶;交
eighth	n.八分之一;第八
dumping	n.倾销
cup	n.杯;杯子v.用杯盛;拔火罐
alibi	n.借口v.为...辩解;辩解
absence	n.缺乏;缺席
vital	adj.生命的;有生命的;紧要的
tower	n.堡垒;塔v.高飞;高耸
thus	adv.如此;因此;迄今为止
risk	n.危险;危险率v.把...作赌注;冒...的危险
refer	v.参考;提到
mummy	n.木乃伊;妈妈
mint	adj.簇新的;铸币厂的n.制造所;尝试v.制造;铸造
keeper	n.看守人;饲养者
hose	n.长统袜;软管v.拍...马屁;痛打
hobby	n.小马;癖好
fortunate	adj.幸运的
curtain	n.帘;幕v.用帘遮蔽
counsel	n.律师;协商v.劝告;交换意见
coat	n.皮毛;上衣v.在...上涂
addition	n.加;增加的人
wit	n.风趣;智力v.知道
transport	n.公共交通;运输v.运输;放逐
technical	adj.技术的
puppet	n.傀儡;木偶
prior	adj.优先的;在先的
model	n.模型;原型v.使仿效;做模型
memo	n.备忘录
liquid	adj.清澈的;清脆的n.流音;液体
felony	n.重罪
choke	n.窒息;阻塞门v.扑灭;塞满
blackmail	n.敲诈v.敲诈;胁迫
suspicion	n.怀疑;一点儿v.怀疑
recover	v.恢复;追回
rally	n.群众集会;重新集合v.召集;集合
psychology	n.心理学;行为科学
pledge	n.抵押;诺言v.许诺;祝愿
nursery	n.苗圃;温床;托儿所
jean	n.牛仔裤
height	n.高;高处
fabric	n.构造;织物
dot	n.点;嫁妆v.打点于;打点
distant	adj.冷淡的;远的
cock	n.公鸡;龙头v.竖起;堆
buy	n.购买v.获得;买
bust	n.前胸;胸像v.爆裂;破产
buff	adj.暗黄色的;裸体的n.暗黄色;打击v.擦亮;作减震器
wax	n.耳垢;蜡v.变成;变大
sleeve	n.套筒;袖子
pudding	n.布丁;血香肠
product	n.产品;产物
philosophy	n.哲理;哲学
irony	n.反语;反语法
hospital	n.兽医院;医院
dope	n.消息;药v.给服药;吸毒
declare	v.表明;宣布
autopsy	n.分析;亲自勘察v.解剖
torch	n.吹管;火炬v.单相思
substitute	n.代替物;代替v.代替;接替
scandal	n.丑行;丢脸;公愤v.讲...的坏话;使丢脸
prick	n.刺痛;一刺v.刺痛;刺
limb	n.大枝;肢;翅膀
leaf	n.长叶;叶v.翻书叶;生叶片
laser	n.激光
hysterical	adj.歇斯底里的
growth	n.生长;增长
fetch	n.拿;灵魂v.拿来;请来
dimension	n.尺寸;范围v.在...上标出尺寸
crowd	n.群;群众v.挨;挤
cousin	n.堂兄弟;远亲
clip	n.剪;弹夹v.剪
climb	n.爬升;攀登v.攀登;爬
bond	n.镣铐;约束v.为...作保;黏合
bee	n.蜂;聚会
ultimate	adj.基本的;极点的n.终点
trust	n.信任;信心v.想;信任
roller	n.滚动物;滚轧机
return	n.回;送回v.回报;回
negotiate	v.做成;谈判
marsh	n.沼泽
majority	n.多数;多数党
lethal	adj.致死的
length	n.长;长段
element	n.成分;要素
deed	n.事情;行为v.立契转让
cigar	n.雪茄烟
bore	n.孔;内膛v.挤出;钻
sponge	n.海绵;纱布v.采集海绵
sleepy	adj.寂静的;想睡的
question	n.难题;问题v.怀疑;问
peek	n.一瞥v.看一眼;偷看
outrageous	adj.无耻的;凶暴的
medal	n.奖牌;圣牌
insult	n.攻击;损伤v.损害;攻击
grudge	n.不满v.勉强地给;怨恨
establish	v.安置;建立
desert	n.荒漠;沙漠v.背离;抛弃
definite	adj.明确的;限定的
capture	n.俘获;俘虏v.夺得;俘虏
wire	n.电线;金属丝v.打电报给;打电报
weed	n.杂草;服装v.除;拣选
suggestion	n.暗示;建议
search	n.检查;搜查v.探;细察
original	adj.起初的n.原型;原作
nickname	n.绰号;名的略称v.给...起绰号;误称
light	adj.淡色的;轻的adv.轻装地n.光;光感v.点;照亮
lend	v.贷;给予
film	n.薄层;胶片v.拍摄;拍摄电影
drunken	adj.醉的
demand	n.需要;要求v.强要;询问
conviction	n.定罪;确信
character	n.品德;性质
bump	n.肿块;重击v.猛击;碰
weigh	v.称出;有分量
weasel	n.告密者;鼬v.告密;狡辩
tempt	v.吸引;引诱
supreme	adj.最大的;最高的
shout	n.呼喊v.呼喊;叫嚷
rocket	n.火箭;芝麻菜v.惊飞;迅速上升
resolve	n.决心;正式决定v.解决;决定
relate	v.讲;适应
poison	n.毒物v.给...服毒药;放毒
pip	n.痂;点;果仁v.烦恼;死
occasional	adj.临时的;偶尔的
meal	n.挤奶;进餐
maker	n.出票人;上帝;制造商
invitation	n.吸引;邀请
haunt	n.巢穴;生息地v.常到;交往
fur	n.毛皮;柔毛
depend	v.信赖;依靠
bond	n.镣铐;约束v.为...作保;黏合
bogus	adj.假的
autograph	n.亲笔;亲笔稿v.亲笔书写
apple	n.苹果
affect	n.内心倾向;自觉感情v.打动;侵袭
tolerate	v.忍受;容忍
southern	adj.向南方的
sleep	n.昏睡;睡眠v.供...睡觉;睡
probation	n.缓刑;试验
perform	v.履行;做
identical	adj.同一的;相同的
herb	n.草药;芳草
fist	n.拳;手v.把...握成拳;拳打
cycle	n.全套故事;循环v.使循环;循环
banner	adj.显著的n.横幅;旗
associate	n.伙伴;准会员v.交往;联合
streak	n.光带;矿脉;条纹v.飞跑;形成条纹
sector	n.部分;扇形v.把...分成扇形
muscle	n.肌肉;瘦肉v.使劲挤出;使劲行进
last	adj.最低的;最后的adv.上一次;最后v.度过;楦
increase	n.放大;增加v.放;增加
hostage	n.人质
heroin	n.海洛因
hardware	n.机器;武器
habit	n.气质;习惯
cult	n.教派;膜拜
consult	v.查阅;考虑
boyfriend	n.男性友人;情人
bail	n.保释;戽斗v.保释;托付
baggage	n.包袱;行李
wealthy	adj.丰富的;丰富
versus	prep.以...为对手;与...相对
station	n.车站;站v.安置
sip	n.抿尝;小口喝v.抿尝;小口地喝
rag	n.破布;破布料v.打扮;责骂
postpone	v.延迟;延缓发作
pad	n.垫;路v.拉长;走
overwhelm	v.覆盖;征服
maniac	adj.疯狂的;躁狂的n.入迷的人;躁狂者
impulse	n.冲动;推动v.推动
hut	n.棚屋;小屋
follow	v.跟随;伴随
duchess	n.公爵夫人;母亲
classy	adj.高级的
celebrity	n.名人;名声
scene	n.地点;一场
rising	adj.上涨的;升起的
reveal	v.揭示;启示
represent	v.代表;使有代表
policeman	n.警察
offensive	adj.进攻的;冒犯的n.进攻
mug	n.脸;脸部照片v.给...拍照;攻读
hypocrite	adj.伪善的n.伪善群;虚伪的人
humiliate	v.使蒙耻
hideous	adj.讨厌的;丑恶的
hairy	adj.盖满毛的;手的
final	adj.决定性的;最后的n.决赛;期终考试
experience	n.经历;经验v.经历
court	n.法庭;球场v.招致;求爱
costume	adj.与服装匹配的n.成套服装;戏装v.为...提供服装
bolt	n.插销;螺栓v.闩;筛
bluff	adj.壁立的;直率的n.矮树林;悬崖v.用大赌注吓退
bedtime	n.上床时间
alpha	adj.第一位的n.第一个;优等
alcoholic	adj.含酒精的;酒精的n.酗酒者
waters	n.海域;近海
visual	adj.光学的;视力的
vegetable	n.蔬菜;植物
tray	n.满盘;盘
suspicion	n.怀疑;一点儿v.怀疑
sticky	adj.困难的;湿热的;粘的
spread	n.翼展;展开v.撒;涂
splendid	adj.有光彩的;壮丽的
smile	n.欢快;微笑v.露出;惠及
shrimp	n.矮子;虾v.捕虾
shout	n.呼喊v.呼喊;叫嚷
root	n.底部;根v.生根;搜寻
ransom	n.赎;赎价v.赎;赎救
press	n.按;压力v.按;挤出
intent	adj.急切的;专心的n.故意;意思
glad	adj.高兴的;乐意的
fling	n.猛冲;扔v.丢下;扔
eliminate	v.排除;淘汰
disorder	n.骚乱;杂乱v.使凌乱;使紊乱
cocaine	n.可卡因
chancellor	n.大臣;总理
cereal	adj.谷物的n.谷类植物;谷物
arrive	v.抵达;出生
technique	n.技巧;技术
subway	n.地下过道;市区地铁
strain	n.品质;系v.拉紧;被扭
statement	n.陈述;声明
servant	n.雇员;仆人
road	n.街道;路
resident	adj.居住的;住校的n.居民;住客
republican	adj.共和党的;共和国的n.拥护共和政体者;共和党人
orb	n.宝球;球v.包围;成球状
lock	n.锁;闸v.拴住;锁
dummy	adj.挂名的;假的n.仿制品;人体模型
discipline	n.纪律;克制v.控制
despise	v.鄙视
dental	adj.齿音的;牙齿的n.齿音
cherish	v.抱有;珍爱
brief	adj.短暂的;距离短的n.辩护状;概要v.作...的提要
bluff	adj.壁立的;直率的n.矮树林;悬崖v.用大赌注吓退
atmosphere	n.大气;空气;大气层
sound	adj.健康的;牢固的n.声;音v.宣告;发音
servant	n.雇员;仆人
rifle	n.来复枪;来复线v.猛投;搜劫
presume	v.冒昧;认定
goal	n.目标;球门
gin	n.酒类;罗网v.喝醉;诱捕
gale	n.大风;微风
faint	adj.微小的;无力的n.昏厥v.变得微弱;昏厥
element	n.成分;要素
cape	n.斗篷;海角
allow	v.允给;允许
whack	n.失灵;重击v.击败;砍
toxic	adj.毒的;中毒的
shepherd	n.保护者;牧童v.护卫;牧
reliable	adj.可靠的
penalty	adj.补偿的;处罚的n.处罚;罚款
panel	n.节间;镶板v.把...分格;镶嵌
overwhelm	v.覆盖;征服
nearby	adj.附近的adv.在附近
importance	n.重要;自大
harass	v.不断打扰;不断侵扰
global	adj.球形的;全球的
fatal	adj.致命的;重大的
endless	adj.无止境的
elsewhere	adv.在别处
doll	n.俊妞儿;玩偶v.打扮得花枝招展
convict	adj.悔罪的n.斑马;已决犯v.证明...有罪
bold	adj.冒失的;勇敢的n.黑体
ballet	n.芭蕾舞;芭蕾舞团
unlikely	adj.未必的
spiritual	adj.精神的n.黑人的圣歌
separation	n.分拣;分离
rusty	adj.锈的;顽固的
record	n.记录;履历v.登记;记录
positive	adj.武断的;有把握的
overcome	v.克服;胜过
mount	n.登;山v.登上;登
method	n.方法;条理
manual	adj.手册的;手的n.键盘;教范
helmet	n.盔;面罩
fail	n.不及格;交割失信v.不;缺乏
essence	n.本体;本质
dose	n.剂量;一次v.给;服药
diagnosis	n.调查分析;诊断
cur	n.劣等狗
claim	n.权利;要求v.要求;主张
bully	adj.霸道的;快活的n.流氓;开球v.威吓;欺负
airline	n.航空公司;航线
yearbook	n.年鉴
various	adj.不同的;各个的
triangle	n.三角;三角铁
tempt	v.吸引;引诱
shelf	n.搁板状物;架子
rig	n.帆装;服装v.装配;操纵
pursuit	n.实行;追赶;追求
pour	v.倒;倾泻
possess	v.具有;拥有
humble	adj.谦逊的v.使谦逊
greedy	adj.渴望的;贪食的
wonder	n.惊奇;奇迹v.感到惊讶;感到疑惑
thorough	adj.彻底的
spine	n.骨气;脊柱
shotgun	adj.被迫做的;猎枪的n.猎枪;媒人
reckless	adj.不顾虑的
railroad	n.隔号余柱;铁道v.速决通过;筑铁路
fiance	n.未婚夫
exposure	n.暴露;揭露
evident	adj.明显的
contempt	n.耻辱;蔑视
capacity	n.充满的;容量
can	aux.可以;能n.大酒杯;容器v.把...装罐保存
weekend	n.周末;周末聚会v.过周末
urge	n.驱策;驱策力v.力劝;推进
thunder	n.雷;恼怒v.打雷;怒喝
theft	n.偷窃;赃物
shipment	n.装运
scissors	n.剪刀;交叉
respond	v.应答;作答
refuse	n.废料v.拒不;拒绝
porter	n.搬运工
noise	n.声音;噪声
match	n.火柴;火绳v.结婚;相称
marine	adj.海的;海军的n.海景画;所有船舶
legacy	n.遗产;遗赠
ink	n.墨水;墨汁v.给..蘸墨;签署
hormone	n.激素
hail	n.欢呼;雹v.欢迎;招呼
gently	adv.缓慢地;平缓的
establish	v.安置;建立
eastern	adj.向东方的
contract	n.合同;合同法v.缩约;皱缩
compound	adj.复合的;群体的n.复合词;复合物v.了结;化合
worldwide	adj.世界范围的adv.在全世界
smash	adj.轰动一时的adv.以哗啦一响n.猛击;钱v.打碎;压扁
sexual	adj.两性的;性的
market	n.集市;市场v.销售;进行交易
jaw	n.口部;颌v.对...唠叨;责骂
intern	n.实习医师;同住者v.拘留
handcuff	n.镣铐;手铐v.束缚...的手脚
errand	n.差事
entertain	v.接受;招待;娱乐
discovery	n.发现;泄露
crib	n.粮仓;饲料槽v.把...关住;偷窃
carriage	n.支架;姿势
barge	n.专用艇v.闯出;专撞
award	n.奖;判决v.判给;授予
attend	v.出席;侍候
ambassador	n.大使;代表
video	n.电视;录像
tab	n.帽耳;襻v.监视;行走
spend	v.花;用
seat	n.坐部;座v.供给...座位;使坐下
rely	v.信赖;依靠
reject	n.被拒货品;阻放装置v.拒绝;拒纳
reckon	v.估计;计算
headache	n.头痛
float	n.浮囊;鱼漂v.注满;浮
embrace	n.接受;拥抱v.接受;信奉
corner	n.包角;角v.垄断;转弯
turner	n.车工;旋转器
sweat	n.出汗;汗v.分泌;出汗
sole	adj.单独的;仅有的n.底部;鳎v.给...装底
restore	v.恢复;使复原
population	n.全部人;人口
pep	n.精力v.使精力充沛
olive	adj.木犀科的;油橄榄的n.油橄榄;橄榄
listen	v.听;听从
jeep	n.吉普车
control	n.管制;指挥v.统制;抑制
cleaner	n.清洁工;清洁器clean的比较级
wooden	adj.木头似的;木制的
slim	adj.机灵的;微薄的v.减轻体重
scent	n.香味;嗅觉v.察觉;觉
quest	n.探险;寻求v.请求;寻求
praise	n.赞美;赞扬v.评价;赞颂
pose	n.态度;样子v.提出;造成
luxury	adj.奢华的n.奢侈;奢侈品
loosen	v.放宽;使松
hum	n.嗯嗯声;欺骗v.哼;欺骗
haunt	n.巢穴;生息地v.常到;交往
gracious	adj.亲切的;体恤的
fleet	adj.短暂的;浅的n.船队;海军
errand	n.差事
emperor	n.皇帝
cake	n.饼;糕饼v.结块
blame	n.责任;指责v.指责;诅咒
abortion	n.流产;堕胎
worship	n.崇拜;敬神v.崇拜;敬奉
strict	adj.完全的;严格的
sketch	n.草图;概述概述;草图;画草图
shift	n.班;变向v.变;替换
physician	n.医生;医治者
perimeter	n.周;周边
passage	n.经过;迁移;通道;走廊
pal	n.好友;同谋v.交友
mere	adj.纯粹的;只不过的
matter	n.实体;事情v.化脓;要紧
grease	n.油脂;脂肪v.用油脂涂
eyewitness	n.目击者
enthusiasm	n.热心;宗教狂热
encounter	n.冲突v.遭到;相遇
diaper	n.花纹织物;尿布v.给...衬尿布
artist	n.能手;艺术家
serve	n.发球;轮到发球v.任;帮佣
punch	n.力量;一拳v.挥击;冲
project	n.工程;计划v.打算;投掷
portal	adj.肝门的;门静脉的n.门;门架
outer	adj.在外的
jewel	n.宝贝;宝石
concrete	adj.具体的;有形的n.凝结物
colleague	n.同事
carrot	n.胡萝卜
bear	n.玩具熊;熊v.忍;压
backyard	n.后院
academic	adj.学理的;学术的n.大学生;学者
wind	n.风;圈;气息v.包;绕
whisper	n.低语;微量v.低声说出;低语
volume	n.音量;卷;体积
terrorist	adj.恐怖的n.恐怖分子;恐吓者
sabotage	n.暗中破坏;阴谋破坏v.破坏
pea	adj.豌豆似的n.豌豆;豌豆荚
organ	n.风琴;机构
needy	adj.贫困的
mock	adj.假的;模拟的adv.假装地n.嘲笑;嘲笑对象v.嘲笑;模仿
mentor	n.门特
measure	n.尺寸;量度v.打量;量
list	n.表;布条v.列举;听
cuff	n.翻边;袖口v.讨论;打
breeze	n.微风;和风v.吹微风;随风传送
article	n.契约;条款;物品;冠词v.列举;进行控告
write	v.记述;写
valid	adj.有根据的;正当的
skipper	n.船长;队长v.当...的船长;当...的队长
sand	n.沙;沙滩v.撒沙于;沙淤
rarely	adv.不常
prank	n.胡闹v.胡闹;打扮
perform	v.履行;做
obnoxious	adj.有害的;讨厌的
mate	n.偶;配偶v.使交配;交配
improve	v.改进;利用
hereby	adv.以此方式;在附近
cheek	n.边柱;面颊v.无礼地向...讲话
cellar	n.地窖;酒窖
void	adj.空的;无效的n.空间;裂缝v.出清;放出
truck	n.交易;商品v.叫卖;打交道
tomato	n.番茄;脸
substance	n.实质;物质
strangle	v.扼死;扼住
sour	adj.发酵的;酸的v.变酸;发酵
skill	n.技术;熟练性
senate	n.参议院;元老院
purchase	n.购买;购置物v.换得;买
native	adj.出生的n.当地人;土人
maximum	adj.极大的;最高的n.顶峰时期;最大限度
fiction	n.小说;虚构
exotic	adj.奇异的;外来的n.外国人;外来词
colored	adj.有...色的;有颜色的n.有色人种的人
clear	adj.纯色的;清晰的adv.离开着;完全v.扫清;变晴
civilian	n.民法专家;平民
brook	n.饶舌者;小溪v.容忍;享有
boutique	n.时装商店
winter	n.冬;寒冷天气v.过冬
terrace	n.平台;梯田;阶地v.使成阶地
speaker	n.代言人;说话者
ski	n.滑橇;雪板v.在...上滑雪;滑雪
seed	n.精子;种v.播;播种
relation	n.关系;亲属关系
quack	adj.假的n.鸭叫声;假行家v.呱呱叫;大肆吹嘘
publish	v.出版;发表
pact	n.契约
opinion	n.评价;意见
knot	n.花结;结v.使紧缩;打结
ketchup	n.番茄酱
item	n.警告;条
disappear	v.使不见;消失
coin	n.钱;硬币v.发明;铸
circuit	n.环道;环行v.绕...环行;环行
assist	n.帮助v.帮助;促进
violet	adj.堇菜科的;蓝紫色的n.堇菜;堇菜花;紫罗兰
tick	n.虱蝇;蜱v.给...标记号;活动
terrify	v.使害怕
tease	n.戏弄v.哄;戏弄
swamp	n.沼泽v.淹没;下沉
secret	adj.秘密的;能保密的n.奥秘;秘密
reflection	n.反射;映像
ray	n.光线;鳐v.放射;照射
part	n.一部分;组成部分v.放弃;分开
mental	adj.精神的;颏的
doubt	n.迟疑;怀疑v.怀疑;迟疑
deception	n.欺骗;受骗
crucial	adj.决定性的;严酷的
chamber	adj.室内的;私人的n.会议厅;室v.装
arrival	n.到达;到达者
visit	n.参观;视察v.访问;视察
support	n.帮助;支撑v.帮助;支持
stall	n.货摊;马厩v.熄火;拖延
scout	n.侦察员;侦察者v.搜索;侦察
scoop	n.匙杓;勺v.挖成;舀
ribbon	n.缎带;色带v.成带状
reserve	n.藏量;储备v.保留;预订
raid	n.侵吞;袭击v.侵吞;袭击
notion	n.概念;观念
income	n.流入;收入
immune	adj.免除的;免疫的n.免疫者
hay	n.成果;干草v.用干草喂
expect	v.等待;预计
edition	n.版本
destined	adj.命中注定的
classroom	n.教室
boob	n.笨蛋;大错v.犯大错
bet	n.打赌;赌金v.敢说;打赌
bath	n.浴;浴水
appoint	v.任命;下令
accomplice	n.共犯;同伙
wander	n.漫游;漂移v.漫游;蜿蜒
seek	v.试图;去
scroll	n.卷轴;名册v.使成卷轴;卷起
retire	v.收口;后退
peach	adj.桃色的n.桃花;桃树v.告发;告密
nude	adj.裸体的;肉色的n.裸体;裸体画
last	adj.最低的;最后的adv.上一次;最后v.度过;楦
fugitive	adj.短暂的;逃跑的n.逃亡者
freezer	n.冷藏室;制冷器
discount	n.打折扣;折扣v.不信;低估
cranky	adj.暴躁的;古怪的
crank	adj.不稳的;怪人的n.怪人;曲柄v.曲折行进;转动曲柄
clown	n.乡下人;小丑v.扮小丑
clearance	n.净空;清除;许可
buffalo	n.野牛v.恐吓;迷惑
anxiety	n.焦虑;渴望
accountant	n.会计人员
whoop	n.高喊;呐喊v.高喊;鸣叫
volunteer	adj.志愿的;自生的n.志愿兵;自愿者v.自愿;自愿提供
terrorist	adj.恐怖的n.恐怖分子;恐吓者
tale	n.陈述;故事
talent	n.明星;天才
stink	n.恶臭;化学v.发出恶臭;惹人讨厌
snake	n.奸险的人;蛇v.拖曳;蛇行
session	n.会议;开庭
remote	adj.边远的;远的
protocol	n.草案;礼仪
nickel	n.五美分;镍v.把...镀镍
garlic	n.大蒜
foreman	n.工头
bed	n.床;卧室v.睡;性交
beam	n.杆;梁v.用...照射;照耀
area	n.地区;面积
altogether	adv.完全;总共
uniform	adj.均匀的n.制服
tremendous	adj.非常的;精彩的
summit	n.顶峰;最高点
squash	adv.挤压地n.挤压;硬挤v.粉碎;硬放
restaurant	n.餐馆
rank	adj.极度肥沃的n.排;行列v.把...分等;级别高于
profession	n.同业;职业
peanut	adj.渺小的n.花生;花生米
observe	v.观察;说
lung	n.肺;呼吸器官
hang	v.吊死;悬挂
expert	adj.熟练的n.特等射手;专家
economy	n.节约;经济
dude	n.城里人;人
donation	n.捐赠;捐赠物
disguise	n.假扮;假装v.假扮;伪装
curb	n.控制;路缘v.控制;勒住
bite	n.咬;咬的伤痕v.刺穿;咬
balloon	n.气球;气球形物v.大大增加
antique	adj.陈旧的;古风的n.古玩;古董
ad	n.作广告
toothbrush	n.牙刷
retreat	n.后退;退却v.退避;退却
represent	v.代表;使有代表
realistic	adj.逼真的;现实的
profit	n.利;利益v.得益;获利
predict	v.预言;作预言
panties	n.短衬裤
lust	n.渴望;性欲v.有强烈的性欲
lid	n.盖;帽子
landlord	n.地主;房东
hesitate	v.稍停;犹豫
focus	n.焦点;焦距v.集中;聚焦
equal	adj.平等的;平均的n.匹敌者;同等的人v.比得上;相等
champ	n.咀嚼;冠军v.捣碎;格格地咬
strand	n.岸;串v.搁浅;搓
rhythm	n.节奏;律动
repeat	n.复写;重复v.复述;重复
puke	n.令人恶心的东西
mechanic	n.工匠;机工
leadership	n.领导;领导才能
juvenile	adj.少年的;幼稚的n.雏鸟;少年
image	n.外形;像v.想象;造像
grocery	n.饭食;食品杂货
freshen	v.使新鲜;变得新鲜
disposal	n.出售;丢掉
cuff	n.翻边;袖口v.讨论;打
consent	n.融洽;同意v.同意;一致
cartoon	n.动画片;漫画v.给...绘草图;画漫画
caffeine	n.咖啡因
broom	n.金雀花;扫帚v.扫;跑开
biology	n.生物;生物学
argument	n.理由;说理
agree	v.承认;表示同意
vanish	v.使不见;变为零
tobacco	n.抽烟;烟草
tin	n.镀锡铁皮;锡
tasty	adj.美味的;雅观的
stack	n.大量;排气管v.洗...作弊;形成堆
sell	n.欺骗;推销v.出卖;卖
pinch	n.撮;捏v.挤压;捏
missile	adj.导弹的;可投射的n.导弹;投射物
flatter	v.胜过;谄媚flat的比较级
expense	n.花钱;价钱
dinner	n.客饭;宴会
cos	n.余弦符号
colleague	n.同事
attorney	n.代理人;律师
war	n.斗争;战斗v.击败;斗争
visit	n.参观;视察v.访问;视察
truce	n.休战;中止v.休战
steer	n.错误指点;阉公牛v.为...操舵;指导
poison	n.毒物v.给...服毒药;放毒
pirate	n.海盗;抢劫犯v.挖;剽窃
immature	adj.幼年的n.未成年人
husband	n.夫;管家v.持有;使有丈夫
heel	n.跟;后跟v.紧跟;倾侧
deliver	v.交出;投递
death	n.灭亡;死
condom	n.阴茎套
butt	n.残端;靶v.捻熄;碰撞
anchor	n.锚;隐士v.固定;抛锚
addict	n.入迷的人;有瘾的人v.使沉溺;使成瘾
trash	n.废话;废物
tournament	n.比赛;锦标赛?
throne	n.宝座;君王v.登上王位
slick	adj.精明的;圆滑的adv.径直;平滑地n.光滑水面;修光工具v.打扮;使光滑
sausage	n.香肠;香肠状物
rain	n.一阵;雨v.下;诉苦
price	n.贿金;价格v.给...定金;定金
needle	n.针;指针v.刺激;穿刺
lean	adj.贫瘠的;瘦的n.倾斜;瘦肉v.屈身;斜
leader	n.领先者;领袖
judge	n.法官;鉴定人v.裁决;断定
ideal	adj.观念的;理想的n.理想;努力目标
detector	n.发觉者;检波器
cast	n.撒网;投v.投
bean	n.豆;嘴峰v.击...的头部
battle	n.格斗;竞赛v.搏斗;作战
batch	n.一批v.分批收集;量出
almighty	adj.极度的;全能的adv.非常
achieve	v.达到;完成
vegetable	n.蔬菜;植物
trapper	n.设陷阱捕兽者
swing	n.摆程;摆动v.挥舞;摆动
sum	n.和;总数v.总结;共计
spark	n.火花;闪光v.点燃;激励
revolution	n.革命;旋转
principle	n.原则;准则
perfection	n.精良;完美
pain	n.痛;痛苦
mole	n.污迹;痣
jelly	n.果冻;胶冻
interview	n.采访;接见;口试v.接见;面谈
initiative	adj.开始的n.首创精神;主动权
hair	n.毛;头发
employment	n.工作;雇用;使用
den	n.洞穴;匪窟v.进洞躲藏;穴居
crack	n.裂缝;瑕疵v.砸开;变粗
count	n.计算;数数v.数;值
compliment	n.敬意;问候v.赞美;称赞
behold	v.看;注视
verge	n.边;路边v.接近;趋向
timer	n.定时器;时计
tap	n.轻拍;酒v.轻拍;放出;开发
surf	n.激浪v.作冲浪运动
stake	n.桩;赌本v.资助;打赌
specialty	n.精制品;专门
snoop	n.窥探行为;窥探者v.窥探
shoot	n.射击;芽v.发射;开
rendezvous	n.集结之地;约会v.约会
passenger	n.乘客;旅人
leverage	n.杠杆作用;力量v.举债经营
jeopardize	v.使处于危险境地
janitor	n.门房
communist	adj.共产党的n.共产主义者
cattle	n.大众;牛
add	v.添加;做加法
ungrateful	adj.不感激的;徒劳的
tutor	n.辅导教师;助教v.训导;训诫
serum	n.浆液;血清
savings	n.存款
pub	n.酒店;旅馆
mouth	n.口;人v.说;做鬼脸
modest	adj.端庄的;谦虚的
method	n.方法;条理
lure	n.吸引力;诱饵v.吸引
jackass	n.公驴;傻瓜
galaxy	n.星系;一群;银河
doom	n.命运;判决v.决定;注定
depth	n.深;深处
bomb	n.炸弹v.大胜;轰炸
beautiful	adj.出色的;美的
arrest	n.逮捕;停止v.逮捕;吸引
approach	n.进路;近似v.近似;靠近
vessel	n.船;飞船;容器
variety	n.变化;种类
traitor	n.卖国贼
smug	adj.整洁的;自命不凡的
smash	adj.轰动一时的adv.以哗啦一响n.猛击;钱v.打碎;压扁
rental	adj.租赁的n.租费;租赁
physics	n.物理;物理过程
monk	n.修道士
mild	adj.味淡的;温和的n.淡味啤酒
jump	n.跳;心神不安v.使跳;跳
inventory	n.存货清单;细帐v.概述
horny	adj.角的;坚硬的
doe	n.雌鹿
develop	v.发展
bang	adv.砰;砰然n.轰声;巨响v.奔;猛击
worm	n.寄生虫病;软体虫v.刺探;潜入
vent	n.出口;排放v.表达;排放
tow	n.拖;绳v.拖;拖行
shaft	n.矿井;轴v.欺骗;推动
recommend	v.劝告;推荐
rainbow	n.彩虹;幻想
overboard	adv.向舷外
literature	n.文献;文学
insight	n.察看;洞悉
heal	v.调停;愈合
haven	n.港;避难所v.使入港
grasp	n.紧抓;理解v.理解;抓
fluid	adj.流体的;易变的n.流体
era	n.纪元;时代
crab	n.蟹v.抓;抱怨
witness	n.证据;证人v.目击;作证
travel	n.旅行;漫游v.经过;旅行
stain	n.染色;色斑v.沾污;玷污
react	v.使起反应;影响
pronounce	v.宣称;宣判
present	adj.出席的;现在的n.现在;礼物v.表示;提出
pour	v.倒;倾泻
pervert	n.背教者v.歪曲;误用
mom	n.妈妈
marriage	n.结婚;结婚仪式
king	n.大王;君主
invest	v.覆盖;投
handful	n.少数;一把
gag	n.塞口物;石斑鱼v.戏弄;窒息
flick	n.轻打;污迹v.弹去;轻打
fireplace	n.壁炉
expertise	n.专家鉴定;专门知识
drum	n.鼓;山脊v.击鼓奏出;打鼓
disappear	v.使不见;消失
concussion	n.猛击;震荡
bruise	n.挫折;青肿v.挫伤;打青
brake	n.闸;揉面机v.刹住;碎
twist	n.转弯v.捻;转动
tide	n.潮;涨潮v.顺潮行驶;发生
summon	v.传讯;召唤
sloppy	adj.潮湿的;溅湿的
scientist	n.科学家
regard	n.关系;敬爱v.敬爱;看待
purpose	n.目的;效用
notch	n.槽口;等v.赢得;交媾
mustard	n.芥菜;芥末
moose	n.麋
extend	v.扩展;伸
exquisite	adj.精美的n.服饰过于讲究的男子
disrespect	n.不尊敬v.不尊敬
complaint	n.抱怨;控告
amateur	adj.外行的n.爱好者;外行
wheat	n.小麦;小麦色
sustain	v.支撑;支持
straw	adj.稻草色的;禾秆的n.禾秆;麦秆吸管
shatter	v.破坏;削弱
ruthless	adj.无情的
record	n.记录;履历v.登记;记录
numb	adj.冷淡的;麻木的v.使麻木;变得麻木
mourn	v.低声哀鸣;感到悲痛
marijuana	n.大麻
manly	adj.适合于男人的adv.具有男子气概地
iris	n.虹;虹膜
hunk	n.大块;大本营
fountain	n.喷泉;源
fellow	n.男人;人
entertain	v.接受;招待;娱乐
earthquake	n.大动荡;地震
drift	n.漂流;漂流物v.穿;漂流
dreadful	adj.可怕的;糟透了的n.廉价刺激性小说
chop	n.砍击;杀死v.砍;剁
appreciate	v.重视;涨价;鉴赏
vague	adj.含糊的
tire	n.疲劳;服装v.厌倦;打扮
stem	n.柄;干v.堵住;堵塞
mad	adj.发狂似的;疯的
hall	n.会堂;酒
gunshot	n.枪弹;射程
embassy	n.大使馆
dozen	n.打;许多
confuse	v.使混乱;使困惑
cleaner	n.清洁工;清洁器clean的比较级
chalk	n.白垩;粉笔v.用粉笔写;变成粉状
breed	n.一窝;种类v.产;饲养
bouquet	n.花束;香味
amulet	n.护身符
warm	adj.感到热的;温暖的v.取暖;同情
villa	n.别墅;花园住宅
unlock	v.揭开;开启
transition	n.过渡;转折语
satisfy	v.符合;满足
relax	v.放宽
lone	adj.独身的;寂寞的
input	n.输入;投入v.输入
fudge	n.乳脂软糖;胡说v.回避;捏造
elaborate	adj.复杂的;苦心的v.精心制作;详述
concerning	prep.关于
channel	n.沟渠;海峡v.输送;在...开槽
category	n.范畴;种类
block	n.大块;街区v.堵塞;阻碍
blend	n.混和;融合v.染黑的毛;协调
blanket	n.床毯;盖毯v.通用于;掩盖
addict	n.入迷的人;有瘾的人v.使沉溺;使成瘾
voter	n.投票人
position	n.恰当位置;位置v.安放;驻扎
mode	n.方法;文体
jolly	adj.大的;快活的adv.很v.怂恿;哄;打趣
initial	adj.开始的;声母的n.首字母;原始细胞v.草签
hunger	n.饿;饥荒v.挨饿;热望
hamburger	n.纯精牛肉;汉堡包
greet	v.接受;问候
greet	v.接受;问候
gram	n.克;祖母
finance	n.财源;财政v.供资金给;赊销
dice	n.小方块;骰子v.冒险;掷骰子
collect	v.取;收
caution	n.警惕;小心v.警告
bicycle	n.自行车v.骑自行车
agree	v.承认;表示同意
writer	n.执笔者;作者
whale	n.鲸;巨大的人v.捕鲸;鞭打
tribe	n.帮;部落
starling	n.掠鸟;分水桩
sacrifice	n.祭品;献祭v.牺牲;献祭
radiation	n.发光;发散
queen	n.酋长夫人;王后
outcome	n.出口;结果
ounce	n.盎司;雪豹
missile	adj.导弹的;可投射的n.导弹;投射物
meter	n.计;邮资机v.用计计量;用表计量
likewise	adv.同样地;也
irrelevant	adj.不相关的;不重要的
felon	adj.卑劣的;凶恶的n.坏人;瘭疽
feature	n.脸型;面貌v.是...的特色;以...为特色
favorite	adj.特别受喜爱的n.受宠的人
farther	adv.此外;更远地far的比较级
fade	v.凋谢;褪去
experiment	n.实验v.进行实验
disk	n.花盘;盘
disco	n.迪斯科舞会
cane	n.笞杖;手杖v.用笞杖打
agony	n.爆发;痛苦
adore	v.崇拜
vein	n.翅脉;静脉v.使有脉络
thieve	v.偷;作贼
surgical	adj.外科的
sunrise	n.晨曦;东方
strange	adj.陌生的;外地的
recital	n.背诵;详述
productive	adj.多产的;生产的
meaningful	adj.有意图的;有意义的
march	n.3月n.行军;边界v.进展;前进
kitten	n.小猫v.产;产小猫
immunity	n.免除;免疫
hassle	n.混乱v.打扰
frighten	v.使惊恐
director	n.导演;董事
dearly	adv.非常;高价地
comment	n.批评;闲话v.评论;注释
closure	n.关闭;结束
cease	n.停止v.停止;停
bomber	n.轰炸机;投弹手
ambition	n.强烈欲望v.有...的野心
wage	n.报酬;工资v.抵押;雇用
unstable	adj.不稳定的;易变的
salvage	n.海上打捞;海上救助v.打捞;抢救
rag	n.破布;破布料v.打扮;责骂
pump	n.泵;抽运v.用泵抽吸;操作泵
petition	n.祈求;请愿v.祈求;请愿
nation	n.国家;国民
mortal	adj.人的;死的adv.极n.人;生物
juicy	adj.多汁的;油水足的
inspire	v.鼓舞;激起
devotion	n.献身;忠诚
dash	n.冲击;猛冲v.溅;猛掷
breach	n.决裂;破坏v.攻破;破坏
bark	n.树皮;吠声v.吠;咳嗽
alternate	adj.间隔的;交替的n.代替者;选择v.交替;轮流
twilight	n.黄昏;暮光
switch	n.长假发;一击v.鞭打;挥动
swallow	n.吞;燕v.吞并;吞没
slot	n.翼缝;足迹;空位v.踢入门;跟踪;安置
scream	n.尖叫声v.尖叫得使;尖叫着说
scar	n.疤;痕v.在...上结疤;结疤
relevant	adj.相关联的;有关的
pound	n.磅;镑v.捣碎;剧跳
pipe	n.管子;烟斗v.吹奏;发尖声
person	n.家伙;人
pawn	n.典当;兵v.当;用...作担保
invest	v.覆盖;投
generation	n.产生;代
difficulty	n.费劲;难
curtain	n.帘;幕v.用帘遮蔽
carnival	n.表演会;游艺团
canyon	n.都市街道;峡谷
boost	n.提高;推动v.举;推动
blue	adj.悲伤的;蓝色的n.蓝色;蓝颜料
bliss	n.极乐;天堂
token	n.表示;特征
tend	v.照顾;期待
stream	n.河;流v.流;飞奔
stock	n.砧木;主干;储备v.备货;发肿
sadness	n.悲哀
recorder	n.记录者;记录装置
owner	n.船长;物主
object	n.对象;物体v.提出;反对
microwave	n.微波
land	n.地产;陆地v.靠岸;落下
gap	n.豁口;间隔v.使成豁口;豁开
fraternity	n.兄弟关系;兄弟会
engine	n.机车;机械
dryer	n.干燥工;干燥剂
cocoa	n.可可粉;可可色
chew	n.咀嚼;咀嚼物v.嚼;深思
brake	n.闸;揉面机v.刹住;碎
bounty	n.慷慨;物产
additional	adj.添加的
acceptable	adj.合意的;可接受的
survivor	n.存者;幸存者
smell	n.气味;嗅觉v.感觉到;嗅
remark	n.言辞;注意v.说;注意
premise	n.假定;上述各点v.引出;预先提出
passenger	n.乘客;旅人
organ	n.风琴;机构
occasional	adj.临时的;偶尔的
indication	n.标示;象征
gutter	n.沟;天沟v.弄熄;流
grab	n.抓;抓具v.逮住;抓
flashlight	n.闪光;手电筒
course	n.进行;行动方向v.追;跑
chain	n.枷锁;链v.束缚
box	n.箱;巴掌v.打;斗拳
blood	n.血;血统
blink	n.闪光;一瞥v.眨;闪亮
beware	v.注意;当心
band	n.群;箍v.聚集
turf	n.草皮;泥炭v.扔掉
swing	n.摆程;摆动v.挥舞;摆动
software	n.软件
slip	n.失脚;片v.滑落;滑行
shovel	n.铲;铲状物v.铲;用铲挖出
shock	n.冲击;震动v.使震惊;震扰
resistance	n.抵抗;抗性
puff	n.喘息;吹v.吹熄;喘息
private	adj.私立的;私人的n.平民;士兵
mirror	n.镜;镜子v.反射;反映
lyric	adj.歌的;抒情的n.歌词;抒情诗
lock	n.锁;闸v.拴住;锁
instrument	n.器械;手段v.向...提交文书
historical	adj.历史的
heartless	adj.没心肝的;无生气的
echo	n.回声;重复v.反射;重复
decade	n.十;十年
comparison	n.比较;相似
childish	adj.孩子的;简单的
cardiac	adj.心脏的;贲门的n.健胃药;强心剂
brace	n.背带;托架v.使防备;支撑
blunt	adj.迟钝的;钝的v.使钝;变钝
admission	n.录用;入场费
utter	adj.绝对的;完全的v.发出;发射
tick	n.虱蝇;蜱v.给...标记号;活动
suspension	n.悬;悬浮
sad	adj.悲哀的;可悲的
resolution	n.决心;判决
purely	adv.仅仅;全然
opponent	n.对手;对向肌
not	adv.并非;不
mankind	n.男子;人类
jerk	n.颠簸;反射v.颠簸;猝然一动
hitch	n.钩;急拉v.钩住;套
flirt	n.调情者;急动v.倏地扔;调情
fare	n.车费;乘客v.吃;过活
extension	n.范围;伸出
equal	adj.平等的;平均的n.匹敌者;同等的人v.比得上;相等
dismiss	v.解雇;去除
delay	n.延迟v.耽搁
decade	n.十;十年
christen	v.给...命名;为...施洗礼
casket	n.首饰盒v.将...装在盒内
broker	n.经纪人;中人v.做掮客
antibiotic	adj.抗生的n.抗菌素
accusation	n.指控;控告
abduct	v.使外展;诱拐;劫持;绑架
witchcraft	n.巫术;魅力
titan	n.大力士
thread	n.思绪;线v.穿;装妥
spell	n.符咒;魔力v.拼作;拼字
shark	n.鲨;骗子v.诈取;诈骗
remain	v.留下;剩余
punch	n.力量;一拳v.挥击;冲
protein	n.蛋白质
print	n.印刷;印刷品v.打上;印
murder	n.谋杀;破坏v.扼杀;谋杀
mask	n.面具;罩v.伪装;掩饰
marathon	adj.有耐力的n.持久的活动;马拉松
intact	adj.完整无缺的
in	prep.在...里面;在...期间
initial	adj.开始的;声母的n.首字母;原始细胞v.草签
height	n.高;高处
diaper	n.花纹织物;尿布v.给...衬尿布
democracy	n.民众;民主
charm	n.美貌;魅力v.使高兴;行魔法
careless	adj.粗心的;随便的
bun	n.小圆面包;甜饼
account	n.记述;解释v.报帐;导致
travel	n.旅行;漫游v.经过;旅行
shred	n.碎片;最少量v.切掉;撕碎
save	prep.除...外v.储蓄;救助
saddle	n.鞍;鞍形山v.给...装鞍;强加
regard	n.关系;敬爱v.敬爱;看待
reference	n.参照;引文出处v.提出...作参考
razor	n.劣酒;剃刀
precinct	n.场地;境域
pistol	n.手枪;信号枪v.用手枪杀死
persuade	v.恳求;说服
pattern	n.模范;样品v.仿制;与...相等
heart	n.内心;心
guarantee	n.保证;担保v.担保;确保
folk	adj.现代民间音乐的n.各位;家属
feast	n.节日;盛宴v.设宴招待;参加宴会
extent	n.范围;广度
disgrace	n.丢脸;失宠v.使丢脸;使失宠
deposition	n.罢免;储存
coverage	n.保证金;覆盖
corridor	n.车厢走廊;走廊
burial	n.弃绝;葬
bronze	n.古铜色;青铜v.变得无情;呈古铜色
bookstore	n.书店
boil	n.翻滚;疖v.煮沸;开
vital	adj.生命的;有生命的;紧要的
veil	n.面纱;幕v.遮盖;变暗
trespass	n.打扰;冒犯v.逾越;打扰
sidewalk	n.人行道
sensible	adj.明智的;知道的
punish	v.罚;贪婪地吃
overtime	adj.加班的adv.超时地n.加班;加班费
optimistic	adj.乐观的
occasion	n.时机;时刻v.引起
obsess	v.困扰;迷住
oak	n.栎木;栎属树
notify	v.警告;通知
jeopardy	n.危险;危险处境
injection	n.充血;注射
hilarious	adj.引人发笑的
distinct	adj.明显的;有区别的
direct	adj.笔直的;直接的adv.径直地v.管理;指示
desire	n.要求;愿望v.渴望;要求
curve	n.曲线;弯曲v.投;弯曲
confide	v.吐露;托付
cone	n.圆锥体;孢子叶球v.使成锥形;结球果
cautious	adj.十分小心的
alter	v.改变;阉割
wilderness	n.莽原
venture	n.冒险;投机活动v.敢于;猜测
tomb	n.坟墓;墓碑v.埋葬
subject	adj.臣服的;需要...的n.题目;学科v.使臣服;提供
stroll	n.散步v.沿...散步;散步
scrub	n.擦洗;擦洗者v.擦;擦掉
rebuild	n.重建v.重建;重新组织
poster	n.招贴;驿马
parallel	adj.并列的;类似的adv.平行地n.平行线;纬线v.使平行;与...相似
ordeal	n.苦难经历;神明裁判
orbit	n.范围;轨道v.进入轨道
nun	n.修女
northern	adj.向北方的n.北部方言;北风
feather	n.禽类;羽v.长羽毛;呈羽状
farmer	n.包税人;农民
fail	n.不及格;交割失信v.不;缺乏
donate	v.放出;捐
distract	v.使混乱;转移
despair	n.绝望v.对...绝望;绝望
democratic	adj.民众的;民主的
defend	v.防御;防守
commercial	adj.商品的;商业的n.商业广告;宣传
ammunition	n.弹药;军火
virtue	n.美德;贞操
thorough	adj.彻底的
tail	n.辫子;尾v.使长尾巴;尾随
sight	n.检查;看见;视觉v.观测;看到
sheer	adj.纯粹的;极薄的adv.陡峭地;完全地n.偏荡;偏航v.使偏航;偏航
seize	v.夺取;掌握
scarecrow	n.稻草人
refresh	v.补充给养;吃点心
prosecute	v.从事;起诉
possess	v.具有;拥有
platter	n.唱片;大浅盘
napkin	n.餐巾;尿布
membership	n.会员身份;会员数
jinx	n.不祥的人;厄运v.使倒霉
heroic	adj.英雄的n.英雄辞令;英雄诗
fag	n.奴仆;香烟v.磨损;辛劳
facial	adj.表面的;面部的n.面部按摩
efficient	adj.收效大的;效率高的
corps	n.队;军;特种部队
attract	v.偷窃;吸引
arrow	n.箭;箭号v.箭一般地飞速行进
ambitious	adj.费劲的;有野心的
wait	n.等待;幕间时间v.等待;等
virtual	adj.事实上的
syrup	n.糖浆;糖汁
solitary	adj.单独的;单个的n.单独监禁;独居者
shuttle	n.梭v.穿梭般来回移动
react	v.使起反应;影响
premature	adj.不成熟的;早产的n.早产儿
pod	n.承窝;荚v.生荚果;聚成群
mortgage	n.抵押;抵押借款v.抵押;以...作担保
journalist	n.记日志者
honor	n.名誉;荣誉v.使增光;尊敬
gravity	n.严肃;重力
gene	n.基因
cheque	n.支票;总收入
chart	n.地图;图v.制订...的计划
cargo	n.大量;货物
acquaint	v.使认识
vest	n.背心;汗背心v.覆盖;授予
untie	v.解开;释放
salute	n.敬礼;行礼v.打招呼;行礼
ruin	n.毁灭;破产v.毁坏;毁灭
resign	v.辞;放弃
priceless	adj.贵重的
pike	n.长矛;尖端;梭鱼v.离开;前进
party	adj.共有的;政党的n.党;队;聚会
myth	n.编造的话;神话
moonlight	n.夜间潜逃;月光v.夜间活动;夜间潜逃
lightly	adv.轻轻地;少许
lift	n.提;天空v.鼓舞;提
keen	adj.刺人的;锋利的
insist	v.坚持;被放置
glow	n.光亮;灼热v.发红;洋溢
generator	n.发电机;发生器
flow	v.流出;流
explosive	adj.暴躁的;爆炸的n.爆发音;炸药
employer	n.雇用者;使用者
confront	v.使面对;迎面遇到
clause	n.从句;条款
cinnamon	adj.肉桂色的n.桂皮;浅红褐色
but	conj.但是
blouse	n.短上衣;工作衣
assassin	n.暗杀者;诋毁者
antidote	n.矫正方法;解毒药
allowance	n.津贴;限额v.定量供应
adjourn	v.使休会;延期
vet	adj.老兵n.检查;兽医v.当兽医
tuck	n.抄网;鼓声v.皱起;塞;击
touchy	adj.棘手的;敏感的
toll	n.敲钟;钟声;交通费v.发出;敲
sequence	n.次序;连续v.确定...的化学结构序列
screw	n.螺钉;阳螺旋v.操纵;旋
program	n.程序;程序设计v.设计程序
pitcher	n.罐;投手
offend	v.冒犯;违犯
kin	adj.同类的n.家属;家族
inherit	v.继承;接过
incapable	adj.无能力的;无资格的
hostility	n.敌意;反对
fuse	n.导火线;引信v.熔合;熔化
funky	adj.惊恐的;时髦的
equation	n.等式;相等
digital	adj.手指的;数字的n.琴键;手指
curfew	n.宵禁
craft	n.工艺;行会v.精心制作
blackmail	n.敲诈v.敲诈;胁迫
allow	v.允给;允许
wealth	n.财富;丰富
turtle	n.海龟;海龟肉v.捕海龟
text	n.课文;课本
starve	v.强迫;挨饿
sleigh	n.轻便有座雪橇v.驾轻便有座雪橇
sarcastic	adj.讽刺的
recess	n.凹处;假期v.使凹进;暂停
rebel	adj.反叛的n.反叛分子;反英分子v.反对;反叛
procedure	n.常规;程序
pirate	n.海盗;抢劫犯v.挖;剽窃
outfit	n.全套服装;一队人v.装备;获得装备
institute	n.学会;学校v.建立;开始
industrial	adj.工业的n.产业工人;工业公司
hoop	n.箍;圈环v.箍;环绕
heartache	n.痛心
hair	n.毛;头发
dynamite	n.达纳炸药v.破坏;炸毁
discreet	adj.谨慎的;朴素的
detect	v.查明;察觉
crack	n.裂缝;瑕疵v.砸开;变粗
climb	n.爬升;攀登v.攀登;爬
chilly	adj.冷淡的;相当冷淡
cater	n.四;四点v.满足需要;斜穿
author	n.发起人;著作者v.发起;著作
vacuum	adj.真空的n.封闭状态;真空v.使用真空装置
urine	n.尿
tunnel	n.地沟;石巷;隧道v.掘;掘隧道
tank	n.池塘;箱v.击败;大量喝酒
sordid	adj.肮脏的;悲惨的
protector	n.保护者;摄政者
portion	n.一部分;一份v.把...分给;命定
pet	n.得宠的人;不高兴v.抚摸;生气
path	n.道路;路
moss	n.苔藓丛;藓沼v.在...上长满苔藓
mat	n.衬垫;地席v.使缠结
length	n.长;长段
hostess	n.女侍;女主人
flaw	n.裂隙;缺点v.使破裂;裂开
flavor	n.特点;味v.给...调味
discharge	n.出院证;发射v.解雇;排
cannon	n.大炮;机关炮v.连击;炮轰
blizzard	n.暴风雨
automatic	adj.必然的;自动的n.自动机械;自动手枪
woody	adj.木头的
urban	adj.城市的
tactics	n.策略;战术
straighten	v.整理;变直
special	adj.特殊的;异常的n.特刊;专列
soil	n.大地;国土v.腐蚀;弄脏
powerless	adj.无力量的
poem	n.诗
playground	n.操场;度假胜地
paranoia	n.多疑症;妄想狂
main	adj.辽阔的;完全的n.体力;叫数
lion	n.名人;狮子
instantly	adv.立即;迫切地conj.一...
hopeful	adj.有希望的n.有希望的青年
havoc	n.大破坏;混乱v.严重破坏
evaluation	n.赋值;估算
engage	v.雇;吸引
diversion	n.牵制;消遣;转变
delight	n.高兴;可爱性v.使高兴;感到高兴
condom	n.阴茎套
companion	n.同伴;职业伴侣
comb	n.浪尖;梳v.精梳;梳
avoid	v.避开;避免
aspen	adj.颤动的;山杨的n.山杨
accessory	adj.附加的;同谋的n.附件;同谋
zap	n.精力;示威v.击败;杀死
whereas	n.以鉴于...开头的文件conj.鉴于;然而
translate	v.翻译;翻译
titanic	adj.钛的
stuff	n.料子;物品v.填没;饱食
speed	n.快;速率v.促进;快走
slime	n.黏泥v.覆有黏液
royalty	n.堂皇;王位
poll	n.民意测验;投票v.获得;投
plaza	n.广场;集市
payment	n.报偿;支付
musician	n.乐师;音乐家
maze	n.错综;混乱;迷宫v.使困惑;使迷乱
marital	adj.夫妻的;婚姻的
magician	n.魔术师;巫师
lurk	v.暗藏;潜伏
lottery	n.抽签法;碰巧的事
journalism	n.新闻学;新闻业
interior	adj.国内的;内的n.本质;内部
imaginary	adj.想象的;虚数的
hog	n.猪v.拱起;修剪
hatch	n.孵化;结果v.筹划;孵出
ethical	adj.道德的;伦理的n.凭医师处方出售的药物
elegant	adj.精确的;上等的
elbow	n.扶手;肘v.用肘推;转弯
custom	n.光顾;习惯
credential	adj.证明可信任的n.文凭;证明书v.为...提供证明书
consistent	adj.坚持的;一致的
collapse	n.崩溃;倒坍v.崩溃;倒坍
cloth	n.布;桌布
claw	n.爪;螯v.逮捕;抓
challenge	n.怀疑;挑战v.向...挑战;提出挑战
board	n.板;纸板v.使搭伙;搭伙
bedside	n.床旁
assumption	n.担任;假定
ant	n.蚂蚁
witty	adj.巧妙的
vast	adj.大量的;高大的
underworld	n.地狱;下层社会
tempt	v.吸引;引诱
tab	n.帽耳;襻v.监视;行走
succeed	v.接替;成功
splash	adv.以扑通一声n.溅;溅起的水v.溅;飞溅
shade	n.荫;阴暗v.隐瞒;遮
selfless	adj.无私的
secrecy	n.保密;秘密
runway	n.河床;滑道
incoming	adj.进来的;新来的
hence	adv.去;因此
gasoline	n.汽油
gain	n.获得;增加v.获得;增加
fund	n.储备;存款v.积累
episode	n.插曲;一个事件
curl	n.卷曲;鬈发v.缠绕;卷
contain	v.包含;可包含
comedian	n.滑稽演员;喜剧演员
collected	adj.镇定的;精神集中的
coconut	n.椰子
buckle	n.搭扣;弯曲v.变形;扣住
assembly	n.集会;与会者
ancestor	n.原型;原种
adjustment	n.调节;调解
acceptance	n.承认;接受
weekly	adj.一周的adv.一周一次地n.周报
warmth	n.激动;暖和
umbrella	n.保护伞;伞
tropical	adj.热带的;炎热的
thumb	n.第一指;拇指v.用拇指揿
throat	n.嗓音;咽
slippery	adj.滑的;油滑的
reform	n.改造;革除v.改革;改造
queer	adj.古怪的;可疑的n.怪人;伪币v.毁坏
poll	n.民意测验;投票v.获得;投
parent	n.父亲;祖先v.做...的父亲
onion	n.洋葱;洋葱头
nose	n.鼻子;气味v.探出;嗅
mobile	adj.动的;流动的n.活动雕塑;活动物体
graveyard	n.墓地;夜班
gifted	adj.杰出的;有天才的
footstep	n.脚步;踏步
cynical	adj.挑剔挖苦的
cement	n.胶结材料;水泥v.巩固;黏结
bull	adj.大号的;雄的n.公牛;玺v.彻底打扫;闲聊
bloom	n.花;开花v.发亮;开花
voyage	n.航程;航海v.航行越过;航海
volunteer	adj.志愿的;自生的n.志愿兵;自愿者v.自愿;自愿提供
verbal	adj.口头的;用言辞的
triumph	n.胜利;喜悦v.征服;获胜
stoop	n.俯身;柱v.俯身;前倾
stamp	n.标志;印v.被捣碎;跺脚
slide	n.滑道;滑行v.打滑;滑行
sink	n.落水洞;污水井v.下沉;下落
regulation	n.调整;管理;规则
region	n.地区;各地区
plumb	adj.垂直的adv.垂直地;恰恰n.垂直;铅锤v.经受;探究
master	n.艺术家;主人v.精通;统治
lingerie	adj.女用内衣的n.亚麻织品
layer	n.层;放置者v.混穿;倒伏
greed	n.贪食
flood	n.洪水;水v.淹没;涌到
essential	adj.本质的;精髓的n.基本必要的东西
elope	v.私奔;逃走
dresser	n.穿衣者;服装员;梳妆台
departure	n.背离;开始
dance	n.跳舞;舞v.舞;舞动
custom	n.光顾;习惯
creation	n.产生;创建
coup	n.棒击;一击;策略;政变v.打翻;倒空
chauffeur	n.汽车司机v.为...开车;当司机
bulletin	n.公告;学报v.公告
veal	n.小牛;小牛肉v.宰牛作食用
tube	n.管;管身
temptation	n.试探;引诱
support	n.帮助;支撑v.帮助;支持
selection	n.选择
sarcasm	n.讽刺;讽刺话
sanity	n.精神健全;清醒
rib	n.肋骨;肋条v.加肋于;戏弄
primitive	adj.简单的;原始的n.原人
platform	n.讲台;台
pending	adj.待收的;未决的prep.在...期间
partial	adj.部分的;偏爱的n.分音
package	n.包裹;包装袋v.包裹;包装
orderly	adj.守秩序的;整齐的
murderer	n.谋杀犯
motto	n.甜格言;警句
meteor	n.流星;陨星
glimpse	n.显现;一瞥v.瞥见;看一眼
ferris	v.搜寻
execute	v.实行;作成;处死
etc	n.等等
ensure	v.保护;保证
dispute	n.斗殴;争吵v.阻止;争吵
damage	n.代价;损害v.损害;受到损坏
crop	n.一批;一熟v.收割;种地
courageous	adj.英勇的
consulate	n.领事馆;领事任期
close	adj.紧的;近的adv.接近地n.结束;终止v.关;关
bee	n.蜂;聚会
amend	v.改进;纠正
unemployed	adj.不用的;未投资的
trace	n.痕迹;迹v.查出;走
testify	v.表明;声明
tendency	n.倾向;趋势
syringe	n.喷射器;注射器v.注射
symphony	n.过门;交响乐
stew	n.混杂物;妓院v.炖;不安
sorrow	n.悲伤;悔憾v.哀痛;懊悔
shaky	adj.不可靠的;颤抖的
scream	n.尖叫声v.尖叫得使;尖叫着说
runner	n.警官;跑动的人
riddle	n.谜;粗筛v.解;筛
remark	n.言辞;注意v.说;注意
poke	n.戮;袋v.拨弄;戳
mention	n.传令嘉奖;提及v.传令嘉奖;提到
mend	n.改进;修理v.改善;纠正
menace	n.讨厌的人;威胁v.威胁
impulsive	adj.冲动的;冲力的
harvest	n.收成;收割v.获得;收割
form	n.模型;形体v.构成;形成
foam	n.大汗;泡沫v.冒泡;起泡沫
economic	adj.经济的;经济学的
divide	n.分界线;分开v.分;分隔
condition	n.健康状况;状况v.使健康;训练
chronic	adj.长期的;慢性的n.慢性病病人
bass	adj.低沉的;低音的n.椴树
whine	n.哀叫声;嘎嘎叫v.哼着发出;嘎嘎响
utter	adj.绝对的;完全的v.发出;发射
thug	n.恶棍;凶手
submit	v.建议;提交
strap	n.带;襻v.约束;被捆
sniff	n.气息;吸气v.觉察出;嗅
sedative	adj.镇静的n.镇静药
rat	n.耗子;鼠v.偷;捕鼠
publish	v.出版;发表
picket	n.尖木桩;警戒队;采集者v.担任纠察
online	adj.联机的;在线的adv.联机地
nowadays	adv.现今
mine	n.矿;矿藏pron.我的v.采;开矿
jumbo	adj.特大的n.庞然大物
invasion	n.侵犯;侵袭
homosexual	adj.同性恋的n.同性恋者
hip	adj.时髦派的n.基节;臀v.使知悉;使沮丧
forget	v.忘;健忘
flea	n.蚤
flatter	v.胜过;谄媚flat的比较级
enter	v.参加;登记
dwell	v.居住;生活
duck	n.鸭;野鸭v.躲避;忽地低下
dent	n.打;齿v.使凹陷;削减
consultant	n.顾问;会诊医师
bikini	n.大爆炸;比基尼泳装
bank	n.岸;堆v.开银行;做庄家
assignment	n.分配;任务
apartment	n.房间;一套房间
ant	n.蚂蚁
affect	n.内心倾向;自觉感情v.打动;侵袭
vile	adj.肮脏的;卑鄙的
toss	n.猛举;扔v.扔;甩
thank	v.感谢;谢谢
stereo	n.立体声;铅版
steal	n.偷盗v.偷盗;偷垒
souvenir	n.记念品
screen	n.屏;纱窗v.放映;遮
scratch	adj.侥幸的n.微伤;抓v.抓;搔
psychopath	n.精神变态者
proportion	n.比例;均衡
out	adv.出;呸prep.从...里面;从...中出来
operative	adj.操作的;有效的n.技工;侦探
obey	v.服从;遵守
neutral	adj.不确定的;中立的n.非彩色;空档
lump	n.块;隆起v.结块;做装卸工
insist	v.坚持;被放置
harass	v.不断打扰;不断侵扰
gloat	n.心满意足v.爱慕地看
flight	n.飞翔;抽逃
filth	n.肮脏;秽亵
extend	v.扩展;伸
electronic	adj.电子的
donkey	n.笨蛋;驴
disease	n.病;病害
coroner	n.验尸官
confess	v.坦白;忏悔
cedar	n.柏;柳杉;雪松
bruise	n.挫折;青肿v.挫伤;打青
betray	v.背叛;泄露
bail	n.保释;戽斗v.保释;托付
attempt	n.攻击;企图v.企图;引诱
appeal	n.呼吁;上诉v.控告;呼吁
wrath	n.愤怒;严酷
wander	n.漫游;漂移v.漫游;蜿蜒
waist	n.上身部分;腰
vain	adj.徒劳的;自负的
trap	n.牢笼;圈套v.从事诱捕;替...装饰
trainer	n.教练机;教员
stepfather	n.继父
public	adj.公开的;公众的n.公众;一群人
president	n.主管人;总统
marshal	n.司仪;元帅v.排列;引领
lemonade	n.柠檬汽水
instruct	v.教;通知
hook	n.钩;陷阱v.钓;钩
heavenly	adj.天国的;天空的adv.至高无上地
hash	n.改头换面v.把...搞糟;把...切碎
halt	n.小站;跛v.踌躇;蹒跚
grim	adj.坚定的;无情的
engineer	n.工程师;机工v.设计
employ	n.工作;使用v.雇用;用
diplomatic	adj.外交的;有手腕的
dilemma	n.二难推理;窘境
contagious	adj.触染性的
cheer	n.欢呼;心情v.对...欢呼;欢呼
carpenter	n.木工v.制作;做木工活
bundle	n.包裹;捆v.捆;收集
bubble	n.冒泡;泡v.激动;冒泡
blank	adj.空白的;空的n.空白v.除去;消失
approach	n.进路;近似v.近似;靠近
appearance	n.出版;出现
wrench	n.扳手;猛扭v.猛扭;抢取
vomit	n.呕吐;喷出v.呕;喷
stadium	n.体育场
smash	adj.轰动一时的adv.以哗啦一响n.猛击;钱v.打碎;压扁
rogue	adj.劣等的;劣种的n.调皮鬼;无赖v.欺诈;去
reflect	v.反射;反映
raft	n.卵筏;木排v.乘筏子渡;乘筏
qualify	v.使合适;限制
pump	n.泵;抽运v.用泵抽吸;操作泵
pillow	n.枕头;轴枕v.把...枕在;枕着头
peep	n.初现;窥孔v.窥;隐现
pageant	n.炫耀;庆典
pack	n.包;小包v.挤;洗
neglect	n.忽略v.忽视;漏做
loneliness	n.孤独
liberal	adj.大量的;慷慨的n.自由主义者
intrude	v.侵扰;侵入
indicate	v.标示;表明
gardener	n.外场手;园丁
freely	adv.直爽地;自由地
address	n.地址;演说v.对付;呼吁
vase	n.花瓶;瓶饰
squat	adj.低矮的;蹲着的n.蹲;窝v.蹲;坐
spice	n.趣味;香料v.加香料于
space	n.场地;空间v.分隔开;留间隔
slave	n.奴隶v.使从属;使做奴隶
shower	n.一大批;阵雨v.喷淋;洗淋浴
rhyme	n.同韵词;韵v.成韵;押韵
relieve	v.发泄;缓解
receipt	n.发票;收到
radical	adj.根本的;根治的n.根部;根式
racket	n.喧嚷;球拍v.喧嚷;用球拍打
preserve	n.禁猎地v.保持;保存
pause	n.停顿;暂停v.踌躇;暂停
overdue	adj.过大的;过期的
official	adj.公职的;正式的n.官员;行政人员
nod	n.点头;懈怠v.点;点头叫
lack	n.缺乏;需要v.短少;缺乏
insect	n.可鄙的人;昆虫
hunter	n.猎犬;猎人
horn	n.角;角质v.用角抵触;装角于
feminine	adj.娇柔的;女性的n.女性;阴性
eyeball	n.眼球v.注视
dump	n.倾倒;倾销v.倒掉;倾卸
disc	n.唱片;磁盘
disappoint	v.失信于;使破灭
crock	n.瓦罐;煤炱v.使受伤;变得衰弱
context	n.上下文
claw	n.爪;螯v.逮捕;抓
clamp	n.夹子;控制v.夹紧;重踩
bishop	n.象;主教
artery	n.动脉;干线
weep	v.悲叹;流泪
vendetta	n.世仇;族间血仇
tenth	n.第十;第十日
suspense	n.挂心;暂停
summon	v.传讯;召唤
spider	n.星形轮;蜘蛛
sing	v.唱;啼
reader	n.读者;教科书
poverty	n.贫乏;贫穷
poppy	n.罂粟;罂粟花
laughter	n.笑;笑意
horizon	n.地平;范围
grove	n.果树林;树丛
frequency	n.次数;频繁
drip	n.滴水声;滴下v.溢出;充溢
differ	v.相异;争论
delta	adj.第四位的;四等的n.三角形物;三角洲
copper	n.铜;铜币
carrier	n.搬运人;承保单位
belief	n.相信;信念
bat	n.短棍;球棒;蝙蝠v.行进;眨
base	adj.基础的;卑劣的n.基;基础v.驻扎;作...的基础
wrap	n.毯子;外衣v.包;覆盖
willing	adj.愿意的
waltz	n.华尔兹舞v.强拉;运输
swell	adj.极好的;时髦的n.膨胀;凸出v.隆起;膨胀
slate	n.板岩;石板v.提;预定
sentinel	n.标记;步哨v.警戒;在...放哨
scrape	n.刮;擦伤v.擦伤;刮
rehearse	v.排练;叙述
prophecy	n.预示;预言
pi	n.π;混乱
organic	adj.器官的;有机的
match	n.火柴;火绳v.结婚;相称
ledge	n.暗礁;壁架
insult	n.攻击;损伤v.损害;攻击
immortal	adj.不死的;不朽的n.神;神仙
heavily	adv.大量地;严重地
hateful	adj.讨厌的
handle	n.把柄;柄v.操作;触
fear	n.害怕;可能性v.害怕;恐怕
doorway	n.出入口;门路
decoration	n.勋章;装饰
buyer	n.采购员;购买者
bedroom	n.卧铺单间;卧室
admiral	n.海军上将;舰队司令
wrestle	n.摔跤v.斗争;深思
velvet	adj.丝绒的n.丝绒
tutor	n.辅导教师;助教v.训导;训诫
scratch	adj.侥幸的n.微伤;抓v.抓;搔
request	n.需要;要求v.要求
privilege	n.特权;特权授予
mart	n.集市;买卖v.经营
madman	n.疯人;狂人
idiotic	adj.白痴的
hotel	n.饭店;公馆
grape	n.葡萄;葡萄色
flexible	adj.柔韧的;柔顺的
enlighten	v.启发;照耀
dairy	n.牛奶公司;乳品间
corrupt	adj.堕落的v.讹用;腐蚀
brunch	n.早午餐
bridesmaid	n.女傧相
bark	n.树皮;吠声v.吠;咳嗽
architect	n.建筑师;设计师v.设计
applause	n.称赞;鼓掌
alongside	adv.在旁边prep.在...旁边
wretched	adj.不幸的;极坏的
tango	n.探戈舞;探戈舞曲v.跳探戈舞
sufficient	adj.自负的;足够的
soak	n.浸泡;湿透v.浸泡;渗透
smooth	adj.光溜的;磨平的v.弄平;铺平
restraint	n.控制;抑制
plead	v.承认;恳求
panda	n.大猫熊;小猫熊
organize	v.组织;组织工会
moral	adj.道德的;有道德的n.典型
loan	n.贷款;暂借v.错出;贷款
loaf	n.面包;肉糕v.闲混;游荡
list	n.表;布条v.列举;听
jumpy	adj.跳跃的
ignorant	adj.不知道的;无知的
germ	n.微生物;芽孢
generosity	n.慷慨;胸怀宽阔
flash	n.闪光;闪亮v.闪;飞驰
convent	n.女隐修会;女隐修院
clumsy	adj.不得体的;笨拙
chocolate	n.巧克力;巧克力糖
captive	adj.被俘虏的;俘虏的n.俘虏;着迷的人
babe	n.宝贝儿;婴儿
vanity	n.空虚;虚荣
trial	adj.审讯的;试验的n.麻烦;试
skate	n.冰鞋;溜冰v.滑冰
shampoo	n.按摩;洗发剂v.洗...的头
republican	adj.共和党的;共和国的n.拥护共和政体者;共和党人
represent	v.代表;使有代表
preview	n.预观;预演v.预观;预演
poisonous	adj.恶毒的;可厌的;有毒的
perjury	n.背信弃义;伪证
parental	adj.父亲的;父本的
mind	n.头脑;智力v.记住;照料
maestro	n.名师;音乐大师
linen	adj.亚麻制的n.内衣裤;亚麻布
learn	v.发现;学
knot	n.花结;结v.使紧缩;打结
interview	n.采访;接见;口试v.接见;面谈
inmate	n.被收容者;居住人
ingredient	n.要素;组成部分
humour	n.心情;幽默v.迁就
gypsy	n.吉卜赛人;吉卜赛语
grind	n.磨;磨擦声v.磨;磨快
greasy	adj.滑溜的;油污的
frost	n.冰冻;霜v.结霜于;结霜
estimate	n.估计;看法v.估计
elementary	adj.基本的;基础的
drastic	adj.激烈的;严厉的
dolly	n.手推车;娃娃v.移动摄影车
database	n.数据库
crow	n.乌鸦;乌鸦座v.欢呼;啼叫
cartoon	n.动画片;漫画v.给...绘草图;画漫画
brag	n.夸耀之词;自夸者v.夸说;自夸
bind	n.括线v.捆绑;束
axe	n.斧;战斧v.解雇;用斧砍断
asset	n.所有物;资产
apparent	adj.表面上的;显然的
worthwhile	adj.值得的
whoop	n.高喊;呐喊v.高喊;鸣叫
volcano	n.火山;喷火
vanquish	v.征服
town	n.城市;镇
survivor	n.存者;幸存者
spotlight	n.聚光灯v.聚光照明
smoke	n.抽烟;烟v.抽;熏制
shop	n.购物;商店;营业v.选购;浏览
sentence	n.句子;命题v.使遭受;宣判
river	n.河;巨流
reveal	v.揭示;启示
reduce	v.减轻;减少
ram	n.白羊座;公羊v.冲;夯
provoke	v.激起;诱导
pin	n.饰针;销子v.按住;别住
peak	n.顶点;尖顶v.使竖起;消瘦
password	n.进入手段;口令
over	adv.报文完;下prep.高于;在...的上方
mop	n.拭子;拖把v.使用拖把;作怪相
jab	n.刺;刺拳v.刺;猛击
imply	v.暗指;缠绕
impatient	adj.切望的;无耐性的
hover	n.翱翔;徘徊v.使悬停;翱翔
endure	v.忍受;容忍
dot	n.点;嫁妆v.打点于;打点
dim	adj.暗淡的;差的n.昏暗;减光v.使暗淡;使减光
debt	n.欠款;义务
culture	n.耕作;教养v.耕作;培养adj.文化的
crawl	n.爬;爬泳v.责备;爬
contain	v.包含;可包含
condemn	v.判刑;谴责
chain	n.枷锁;链v.束缚
breath	n.呼吸;气息
booty	n.掠夺物;战利品
arctic	adj.北极的;极冷的n.北极
ambrosia	n.仙果;珍馐美味
add	v.添加;做加法
warm	adj.感到热的;温暖的v.取暖;同情
wand	n.棒;魔杖
soak	n.浸泡;湿透v.浸泡;渗透
profound	adj.深沉的;深邃的n.海;深邃
people	n.人;人民v.居住于;使充满
mock	adj.假的;模拟的adv.假装地n.嘲笑;嘲笑对象v.嘲笑;模仿
merit	n.长处;功德v.应得;值得
load	n.负荷;思想负担v.装;装货
link	n.环;环节v.串连;挽住
investor	n.投资者
interview	n.采访;接见;口试v.接见;面谈
hustle	n.忙碌;推v.催促;难
forensic	adj.辩论的;法庭的n.辩论练习;辩论学
food	n.食物;养料
duct	n.导管;管v.用管道输送
drawer	n.抽屉;制图员
democrat	n.有民主精神者
conquer	v.攻取;破除
clarify	v.澄清;净化
chore	n.家庭杂务
charter	n.特权;特许状v.包;订约租
butcher	n.肉商;屠夫v.残杀;屠宰
brick	n.砖;砖块状物v.用砖砌;用砖围住
blush	n.红色;脸红v.脸红;羞愧
wreck	n.残骸;沉船v.破坏;损害
wit	n.风趣;智力v.知道
waffle	n.蛋奶烘饼;胡扯v.含糊其辞;胡扯
unfaithful	adj.不如实的;不忠实的
tribute	n.贡;贡税;赞辞
teller	n.出纳员;计票人
rope	n.粗绳;绞索v.用绳捆;成绳状
respond	v.应答;作答
resident	adj.居住的;住校的n.居民;住客
reel	n.卷轴;筒管v.放出;卷;摇晃
rave	n.胡言乱语;围杆v.呼啸;说胡话
priest	n.祭司;司铎
postcard	n.明信片
overseas	adj.海外的adv.在海外
onion	n.洋葱;洋葱头
newly	adv.新近;重新
morphine	n.吗啡
lotion	n.洗液;濯身
limitation	n.局限;限度
lecture	n.讲稿;训斥v.给...讲课;训斥
lad	n.家伙;男孩
kidney	n.个性;肾
judgement	n.判断;判决
jog	n.暗示;慢跑v.触动;轻摇
jingle	n.丁当声;广告短诗v.发出了丁当声
jet	n.喷嘴;煤玉v.喷出;喷射
itch	n.疥疮;痒v.发痒;渴望
install	v.安顿;安装
infant	adj.婴儿的;幼稚的n.初学者;婴儿
indefinite	adj.不明确的;不确定的
hazard	n.机会;危险v.冒险作出;使冒危险
grenade	n.格林纳达;榴弹;手格林
glamorous	adj.富于刺激的
fireman	n.爆破工;司炉工
faculty	n.官能;系
engineer	n.工程师;机工v.设计
discretion	n.谨慎;决定
delusion	n.错觉;欺骗
crate	n.板条箱;一箱的量v.用板条箱装
competent	adj.有能力的;有效的
breaker	n.破碎者;碎浪
attempt	n.攻击;企图v.企图;引诱
asylum	n.避难;避难所
apply	v.涂;应用
wedge	n.楔形;楔子v.挤入;楔入
warrior	n.勇士;战士
wager	n.打赌;赌注v.押;打赌
unfit	adj.不合适的;不健康的
treatment	n.处理;对待
torment	n.痛苦;刑具v.纠缠;歪曲
spinal	adj.棘的;脊的n.脊髓麻醉
scenery	n.风景;舞台布景
republic	n.共和国;团体
repair	n.修理;前往v.恢复;去
rabble	n.下等人;一大堆v.聚众袭击
perk	v.昂起;昂首
owl	n.猫头鹰
override	v.不顾;撤销
mail	n.邮件;邮政v.邮寄;寄出
lime	n.石灰;椴
lettuce	n.莴苣;生菜
intimidate	v.恫吓
instructor	n.大学讲师;教员
guard	n.警戒;警卫员v.保守;看守
grieve	v.伤害;使伤心
gorilla	n.暴徒;大猩猩
globe	n.地球;天体v.使成球状;呈球状
extensive	adj.广泛的;广阔的;大量的
exercise	n.履行;运动v.履行;训练
down	prep.往...的下端;沿
doorbell	n.门铃
device	n.手段;装置
dam	n.坝;老娘v.阻止
cultural	adj.耕作的;文化的
credit	n.信任;信誉v.把...归于;信任
commerce	n.交往;商业v.交往
chemical	adj.化学的n.化学品
cafe	n.咖啡;咖啡馆
authentic	adj.可靠的;真的
alter	v.改变;阉割
vegetarian	adj.吃素的;蔬菜的n.食草动物;素食者
tune	n.曲调v.调音;合调
tourist	n.旅游者
telegram	n.电报
suitable	adj.合适的;类似的
stalk	n.柄;茎v.在...蔓延;蔓延
spring	n.弹性;反弹;春天v.惊起;跳
specimen	n.样本
spar	n.翼梁;圆材v.用栓闩紧;争论
satisfy	v.符合;满足
request	n.需要;要求v.要求
publisher	n.出版者;业主
pharmacy	n.配药业;药房
pen	n.笔;圈v.起草;写
obstacle	n.栅栏;障碍
grandchild	n.孙子
genuine	adj.真诚的;真诚
flush	adj.充裕的;紧接的adv.齐平地;直接地n.冲洗;急流v.发红;涌
fluid	adj.流体的;易变的n.流体
dove	n.鸽;圣灵
ditch	n.沟;海v.开沟;逃学
criticism	n.批评;评论
cramp	n.绞痛;痉挛v.把...关住;痉挛
contribute	v.捐;投
connect	v.联系;连接
bunk	n.床铺;垫木v.合住;睡觉
bomb	n.炸弹v.大胜;轰炸
billion	n.十亿;大量
bankrupt	adj.破产的n.破产者v.使枯竭;使破产
wrist	n.腕;腕部
winner	n.获胜者
ultimatum	n.最后结论;最后通牒
thirst	n.渴;渴望v.感到口渴;渴望
sucker	n.吮吸者;吸血鬼;吸盘v.欺骗
spell	n.符咒;魔力v.拼作;拼字
sniff	n.气息;吸气v.觉察出;嗅
shake	n.握手;摇动v.撒;摇
scope	n.范围;眼界
retrieve	n.救出险球v.检索;使恢复
pump	n.泵;抽运v.用泵抽吸;操作泵
predict	v.预言;作预言
pigeon	n.鸽子
neurotic	adj.神经机能病的
monitor	n.班长;告诫者v.监测;监控
microphone	n.扩音器
mechanical	adj.机械制的;有机器的
limp	adj.软的;软面的n.跛行v.格律不顺
hatchet	n.短柄小斧;轻便斧
fill	n.充分;装填物v.挤满;装满
feed	n.饲料;喂食v.维持;喂
doubt	n.迟疑;怀疑v.怀疑;迟疑
dedication	n.奉献;献身
cellular	adj.多孔的;细胞的
carbon	n.复写纸;碳
butterfly	n.蝶泳;蝴蝶
bumper	n.满杯;反弹球adj.丰富的
visible	adj.明显的;现有的
ventilator	n.呼吸器;通风设备
unpack	v.卸下负荷
unload	v.摆脱;倾诉
universal	adj.全体的;宇宙的n.共相;谓项
target	n.靶;目标v.规定...的指标
suggest	v.建议;意思是
strawberry	n.草莓;林石草
spook	n.鬼;间谍v.代写;吓唬
sap	n.液;元气v.削弱;挖坑道
reassure	v.给...再保险;向...再保证
prey	n.捕食;牺牲品v.捕食
persuasive	adj.劝说的
pancake	n.薄煎饼;湿粉饼v.使平展;平伸
old	adj....岁的;老的
mix	n.混合;混合物v.拌成;和入
matrimony	n.婚礼;觅对
marine	adj.海的;海军的n.海景画;所有船舶
mail	n.邮件;邮政v.邮寄;寄出
magnet	n.磁体
lighthouse	n.灯塔
liability	n.倾向;责任
headline	n.标题;栏外标题v.给...加标题
gangster	n.大麻烟;歹徒
factor	n.系数;因素v.代理经营;做代理商
explosive	adj.暴躁的;爆炸的n.爆发音;炸药
dispatch	n.急件;派遣v.派遣;赶紧
detail	n.细部;细节v.列举;详述
curly	adj.波纹的;卷曲的
condolence	n.吊唁
comrade	n.伙伴;同人
bulb	n.电灯泡;球茎
await	v.等候;侍候
assault	n.攻击;强奸v.攻击;困扰
ambush	n.伏击者;埋伏v.伏击;打埋伏
aircraft	n.飞机
adolescent	adj.青春期的;青少年的n.青少年
adjust	v.调节;解决
abort	n.中途失败v.败育;流产;堕胎
yank	n.突然的猛拉v.猛拉;猛地一拉
whit	n.一点点
verse	n.韵文;诗;节v.使熟练
vague	adj.含糊的
undermine	v.暗中破坏;在...下挖
trim	adj.苗条的;整齐的n.调整;情形v.剪;调整
swamp	n.沼泽v.淹没;下沉
sunlight	n.日光
stitch	n.缝法;一针v.缝;联接
sphere	n.球;星;领域
slipper	n.浅口便鞋
slash	n.鞭打;砍;叉口v.鞭打;砍
sincere	adj.不搀假的;诚实的
sigh	n.叹气v.悲叹;渴望
setback	n.挫折;逆流
secondly	adv.第二
retail	adv.以零售方式n.零售;零售商v.零售;详述
prospect	n.景象;可能性v.勘探;有希望
precaution	n.预防;预防措施
pearl	adj.小颗粒的;珍珠的n.珍珠;珠状物v.采珍珠;成珠状
park	n.公园;狩猎区v.停放;停放车辆
melt	n.融化;脾v.融化;溶解
material	adj.身体上的;物质的n.布;材料
mar	n.污点v.毁坏
liaison	n.联络;联系
lair	n.兽窝;泥沼v.进入;陷入泥沼
hot	adj.辣的;热的
hook	n.钩;陷阱v.钓;钩
headline	n.标题;栏外标题v.给...加标题
hag	n.女巫;沼地
grape	n.葡萄;葡萄色
fury	n.狂暴;狂怒
felicity	n.快乐;恰当
fang	n.尖牙;牙齿
earring	n.耳环
draw	n.被拉的量;拉v.拔出;拉
dictate	n.命令v.口授;口授
dependent	adj.隶属的;依靠的
cope	n.顶点v.应付;对付
cola	n.可乐;可乐果树colon的复数
cocktail	adj.鸡尾酒会的n.合成物;鸡尾酒
bump	n.肿块;重击v.猛击;碰
blackout	n.灯火管制;断电
backfire	n.逆火;迎火v.发生逆火;发生意外
apron	n.回车场;围裙
adjust	v.调节;解决
vouch	n.保证v.担保;引证
vitamin	n.维生素
vista	n.界域;狭长通道;远景
vintage	adj.上等的;全盛时期的n.酒
urn	n.壶;瓮
uncertain	adj.不确定的;无常的
tourist	n.旅游者
tattoo	n.纹身;归营号v.刺
surround	v.包围;围住
stern	adj.坚定的;臀的n.船尾;臀
sponsor	n.保人;倡议者v.倡议;发起
slimy	adj.污秽的;黏泥的
single	adj.单程的;单人的n.单曲唱片;一个v.选出
reign	n.统治;主宰v.盛行;为王
publish	v.出版;发表
planet	n.地球;行星
pickle	n.盐卤;麦粒v.酸洗;葬送
peculiar	adj.奇怪的;特殊的
parasite	n.寄生虫;寄生生物
listener	n.收听者;听者
knock	n.一击;指责v.敲;敲
grain	n.谷;谷粒
fearless	adj.不怕的
exit	n.出口;出去v.离开;出去
disconnect	v.使不连接;分离
design	n.设计;图案v.决意;谋划
crook	adj.不老实的;有病的n.曲柄杖;弯曲v.篡改;弯曲
crook	adj.不老实的;有病的n.曲柄杖;弯曲v.篡改;弯曲
convenient	adj.近处的;省力的
content	adj.高兴的;满意的n.内容;满意v.使满意
colon	n.结肠;冒号
barber	n.理发师v.剪短;饶舌
wink	n.闪烁;瞬间v.眨;眨掉
warp	n.变形;偏见v.使变形;歪曲
steer	n.错误指点;阉公牛v.为...操舵;指导
stag	adj.限于男子的adv.无异性陪伴地n.成年牡鹿;幼马v.告发;截短
stability	n.稳定;稳固
repeatedly	adv.一再
radius	n.半径;周围
pitch	n.投;投球v.投;支搭
pair	n.一双;一条v.成对;配合
painter	n.画家;油漆匠
notebook	n.笔记薄
morning	n.初期;破晓
moody	adj.郁郁寡欢的
mash	n.糊状物;迷恋v.压碎;挑逗
invent	v.发明;捏造
indulge	v.纵容;沉溺
festive	adj.欢乐的;节日的
feather	n.禽类;羽v.长羽毛;呈羽状
eyebrow	n.窗头线;眉
expand	v.扩大;张开
enjoy	v.经历;享有
dictionary	n.词典;术语大全
dialogue	n.对话v.对话
dealer	n.发牌者;商人
critic	adj.批评的n.批评家;校勘家
cowboy	n.放牛娃;牧牛工
consult	v.查阅;考虑
canal	n.沟渠;管
belt	n.带;腰带v.飞驶;猛击
banana	n.香蕉;香蕉味
audition	n.面试;听;试唱v.试演
ape	n.猴;模仿者v.模仿
adventure	n.冒险;生意v.拿...冒险;冒险
withdraw	v.抽回;取消
wishful	adj.渴望的
violin	n.小提琴;小提琴手
vehicle	n.传播媒介;交通工具
vanish	v.使不见;变为零
unbearable	adj.难以忍受的
tonic	adj.紧张的;主音的n.补药;主音
tackle	n.索具;用具v.对付;抓获
suffice	v.使满足;足够
suction	n.吸;吸力
sport	n.玩笑;游戏;运动v.夸示;浪费
slay	v.杀;消灭
rock	n.大石;矿石v.轻摇使;轻摆
rate	n.比率;费率v.呵责;骂走
polo	n.马球
oval	adj.椭圆形的n.椭圆形
noisy	adj.嘈杂的
nauseous	adj.使人厌恶的
mild	adj.味淡的;温和的n.淡味啤酒
midst	n.中部prep.在...之中
map	n.地图;图v.勘测;被安置
liable	adj.会...的;有...危险的
individual	adj.独特的;个别的n.个人;人
hunt	n.打猎;猎区v.追猎;摆动
hen	n.雌禽;雌性
frequent	adj.经常的v.常到;交往
fisherman	n.渔船;渔民
elephant	n.特大品种;象
dislike	n.不和;不喜爱v.不喜爱;使不高兴
diploma	n.公文;执照
decorate	v.粉刷;装饰
carve	v.雕刻;切开
career	n.成功;全速;职业;专业v.使奔驰;奔驰adj.职业的
bond	n.镣铐;约束v.为...作保;黏合
bash	n.尝试;猛击v.猛击;当妓女
white	adj.白色的;无血色的n.白色;纯洁
tradition	n.传统;口传;惯例
surgeon	n.军医;外科医师
snoop	n.窥探行为;窥探者v.窥探
salvation	n.救助;救助者
remorse	n.怜惜;痛悔
pie	n.财富;派;馅饼
outsider	n.局外人
northwest	adj.在西北的adv.向西北n.西北;西北部
nausea	n.恶心;晕船
napkin	n.餐巾;尿布
mule	n.笨蛋;骡
mourn	v.低声哀鸣;感到悲痛
melt	n.融化;脾v.融化;溶解
mechanism	n.机构;机械装置
mash	n.糊状物;迷恋v.压碎;挑逗
maiden	adj.少女的;首次的n.处女;少女
inherit	v.继承;接过
greatness	n.巨大
edge	n.边;刀口v.加边于;使锋利
drift	n.漂流;漂流物v.穿;漂流
cubicle	n.小房间;小卧室
college	n.大学;职业学校
choose	v.情愿;欲;挑选
checkup	n.体检
candidate	n.候选人;投考者
buffet	n.打击;抖振;自助餐v.打;打击
bandage	n.绷带;带子v.用绷带扎缚
automobile	n.汽车v.乘汽车
athletic	adj.健壮的;体育的
alarm	n.惊恐;警报v.打扰;使惊恐
absorb	v.把...并入;吸收
absent	adj.不在场的;缺乏的v.使缺席
vitamin	n.维生素
viper	n.蝰蛇
spear	v.刺;用矛刺
slit	n.狭长的口子v.切掉;切开
scheme	n.计划;系统v.计划;密谋
roar	n.大笑声;吼声v.吼叫;喧哗
relative	adj.比较的;相对的n.关系代词;亲戚
quarry	adj.方形的n.采石场;方形石v.努力发掘
prosecutor	n.从事者;原告
prognosis	n.预测;预后
probe	n.探索;探针v.探索
potential	adj.潜在的;势的n.潜力;潜在性
pitiful	adj.可鄙的;可怜的
persistent	adj.持续的
perception	n.感知;认识
percentage	n.百分比;所占比例
pea	adj.豌豆似的n.豌豆;豌豆荚
meter	n.计;邮资机v.用计计量;用表计量
limbo	n.监狱;林波舞
liar	n.说谎的人
karate	n.空手道
hump	n.驼背;驼峰v.溜放;隆起
holler	n.号子;叫喊v.喊出;叫喊
hazel	adj.榛木的;榛树的n.榛木;榛树
haw	n.山楂;树篱v.发呃声;向左转
gauge	n.标准量度;测量仪器v.估计;量
function	n.功能;官能v.工作;行使职责
fiasco	n.完全失败;长颈瓶
dense	adj.稠密的;极度的
crimson	adj.深红色的;血淋淋的n.深红v.变绯红色;成熟
continent	n.洲;大陆
command	n.命令;指挥v.俯临;命令
colorful	adj.富于色彩的
clam	n.蛤;抓斗v.挖蛤
cider	n.果汁;苹果汁
brochure	n.论文;小册子
behaviour	n.态度;行为
bargain	n.交易;协定v.用...交换;讲价
awe	n.敬畏;恐惧v.使敬畏
artistic	adj.艺术的;艺术家的
arena	n.场地;角斗场
wiggle	n.扭动;扭动状线v.使扭动;扭动
weigh	v.称出;有分量
villain	n.恶棍;坏蛋
vein	n.翅脉;静脉v.使有脉络
vanquish	v.征服
stain	n.染色;色斑v.沾污;玷污
snack	n.快餐;一份;零食v.吃快餐;尖刻地说
smear	n.涂片;污迹v.诽谤;弄脏
secondary	adj.次的;第二的
rough	adj.不平滑的;未加工的n.粗人v.对...动粗;使不平
ritual	adj.礼节性的n.程序;仪式
pint	n.品脱;一品脱啤酒
pension	n.工钱;津贴v.用津贴拉拢
penguin	n.企鹅
passive	adj.被动的;冷漠的n.被动态
panther	n.豹;美洲狮
overhear	v.无意中听到
origin	n.出身;起端
orchestra	n.管弦乐队
mount	n.登;山v.登上;登
morality	n.道德;德行
lab	n.实验室
icy	adj.冰的;冰冷的
hoover	n.真空吸尘器v.用吸尘器清洁
hoot	adv.啐n.大叫;报酬v.喊叫;鸣叫
hippie	n.嬉皮士
handshake	n.握手
grill	n.烤菜餐馆;烤架v.拷问;烤炙
function	n.功能;官能v.工作;行使职责
formality	n.拘谨;礼节
elevator	n.电梯;起重机
drum	n.鼓;山脊v.击鼓奏出;打鼓
depth	n.深;深处
confirm	v.巩固;证实
civilian	n.民法专家;平民
bypass	n.分路器;旁道v.绕过;越过
brief	adj.短暂的;距离短的n.辩护状;概要v.作...的提要
breed	n.一窝;种类v.产;饲养
boxer	n.斗拳狗
bind	n.括线v.捆绑;束
audio	adj.声音的;音频的n.音的播送;音频信号
acre	n.英亩
accidental	adj.非主要的;意外的n.临时记号;突出光线
ulterior	adj.日后的
thug	n.恶棍;凶手
thigh	n.股;股节
softball	n.垒球;垒球运动
snag	n.潜在的困难;抽丝v.挂住;抓获
sling	n.吊带;吊索v.吊;抛
shell	n.蛋壳;壳v.脱壳;剥去;炮轰
seed	n.精子;种v.播;播种
rumour	n.咕哝;名誉v.谣传
ripe	adj.成熟的;富的
reluctant	adj.不情愿的;阻挠的
regular	adj.定时的;恒常的n.常客;正规兵
promote	v.促进;提升
precise	adj.精确的;清晰的
popularity	n.百姓;普及;受欢迎
pin	n.饰针;销子v.按住;别住
perceptive	adj.感知的;理解的
oral	adj.口的;口服的n.口试
miraculous	adj.奇迹般的;神奇的
memorable	adj.值得纪念的
maternal	adj.母亲的;母系的
lookout	n.观察所;观察员
long	adj.长的;长时间的adv.长久;始终v.渴望;归属
lockup	n.拘留所;锁
local	adj.局部的;位置的n.当地居民;市郊列车
lizard	n.蜥蜴;蜥蜴皮
librarian	n.图书馆馆长
knight	n.爵士;骑士v.授...以爵士品位
inspection	n.检查;检阅
impression	n.压印;印象
immoral	adj.不道德的;放荡的
guard	n.警戒;警卫员v.保守;看守
gourmet	n.美食家
fighter	n.好斗者;战士
fee	n.采邑;费
feature	n.脸型;面貌v.是...的特色;以...为特色
fax	n.传真机;事实v.传真传输
extortion	n.勒索钱财;敲诈
express	adj.明确的;专门的adv.特意地;用快递n.捷运公司;快车v.表示
essential	adj.本质的;精髓的n.基本必要的东西
downright	adj.清楚的;直率的adv.彻底地;清楚地
digest	n.文摘;摘要v.消化;蒸煮
cranberry	n.越橘
covert	adj.掩盖的;隐蔽的n.覆羽;隐蔽
chorus	n.副歌;合唱v.副歌
bygone	adj.过去的
buzz	n.谣言;吱吱声v.说闲话
bury	v.埋葬;掩埋
bike	n.巢;群v.骑自行车;蜂拥
attend	v.出席;侍候
well	adj.对的;井的adv.好;很n.好;井v.涌出;流出
weary	adj.疲劳的;厌倦的v.渴望;疲劳
visa	n.签证;签字
view	n.观看;视力v.查看;观看
train	n.连串;列车v.把...对准;训练
tickle	n.轻触使痒;痒v.使高兴;使欢娱
tap	n.轻拍;酒v.轻拍;放出;开发
sweep	n.扫;扫荡v.扫;扫去
stepmother	n.继母
stale	adj.陈腐的;污浊的n.尿;笑柄v.低估;撒尿
settle	v.安放;定居
seat	n.坐部;座v.供给...座位;使坐下
resign	v.辞;放弃
rat	n.耗子;鼠v.偷;捕鼠
pro	n.公关人员adv.从正面n.赞成的论点prep.在...之前;赞成
plumber	n.堵漏人员;管子工plumb的比较级
piss	n.尿;啤酒v.尿;排
pilot	n.驾驶员;向导v.驾驶;为...引航
ownership	n.所有权;占有
occur	v.存在;发生
merger	n.合并;吸收
ludicrous	adj.荒唐可笑的
inject	v.插;注射
heat	n.热;体温v.使热;变热
fault	n.错误;缺点v.产生断层;犯错误
express	adj.明确的;专门的adv.特意地;用快递n.捷运公司;快车v.表示
dire	adj.可怕的;阴沉的
centre	n.心;正中v.集中;居中
carrot	n.胡萝卜
calm	adj.安静的;平静的n.安静;镇静v.使平静;平静下来
budge	n.羔羊皮v.推动;改变意见
bridge	n.鼻梁;桥v.架桥于;跨越
ankle	n.踝
vend	v.出售;售出
swift	adj.迅速的n.褐雨燕
snow	n.下雪期;雪v.用雪困住;下雪
shade	n.荫;阴暗v.隐瞒;遮
scattered	adj.分散的;散射的
sanctuary	n.高坛;圣所
saint	n.圣徒v.正式封...为圣徒
regain	v.返回;取回
raise	n.高岗;提高v.举起;竖起
process	n.步骤;过程v.对...起诉;列队行进
orphan	adj.无父母的n.孤儿;遗孤
nipple	n.螺纹接套;乳头
mural	n.壁画
