the	det.定冠词;表示特指
of	prep....的;含有...的
and	conj.和
to	prep.到;离
in	prep.在...里面;在...期间
that	det.那个
his	pron.他的;它的
he	pron.他;一个人
it	pron.它
with	prep.加在...上;在...一边
for	prep.为;为了
as	prep.当作;像conj.当...时;像...
you	pron.你;你这个
not	adv.并非;不
be	v.表示;是
her	pron.她
on	prep.靠近...;在...里
at	prep.向;在...里
by	prep.偏于;在...旁边
which	pron.那个;那些
have	v.拿取;有
or	conj.或者
from	prep.从;从...来
this	pron.后者;这
him	pron.他
but	conj.但是
all	adv.单单;更其pron.全体;一切
she	pron.它;她
they	pron.人们;他们
my	det.我的
me	pron.我
one	n.一;一体
their	det.他们的
so	adv.啊;同样conj.为了;因此
an	det.一
them	pron.那些;他们
we	pron.我们;人们
who	pron.谁;他
will	aux.将;能n.决心;意愿
no	adv.不;毫不n.不;反对票
when	adv.其时;什么时候conj.其时;一...就
there	pron.那里
if	conj.假如;使
more	adj.更大的;另外的adv.更;再
out	adv.出;呸prep.从...里面;从...中出来
up	prep.往...的上端;往...的上游
into	prep.朝;进
do	v.做
any	adv.多少;略pron.若干
your	det.你的
what	pron.什么;无论什么
man	n.男子;人
other	adj.别的;不同的n.对立的事物
than	conj.比;除...
our	det.我们的
some	pron.很多;一些
very	adv.非常
time	n.时间;时刻v.调准;为...定时
upon	prep.覆盖;接触
about	adj.活动中的prep.在...附近;在...前后
may	aux.会;可能n.五月
its	det.它的
only	adj.独生的;唯一的adv.不料;只
now	pron.现在
like	adj.相同的;相像的prep.比如;像conj.好像;如同v.喜欢;要
little	adj.小的;幼小的adv.毫不;难得
then	pron.那时
can	aux.可以;能n.大酒杯;容器v.把...装罐保存
us	n.美国pron.人们;我们
such	adj.那么的;这种的
a	det.一
great	adj.大的;久的n.大人物
before	adv.较早;以前prep.在...前面;在...以前conj.不愿...;在...以前
must	aux.必须;务必
two	n.第二;二
these	det.这些
see	v.察看;看
know	v.记住;确知
over	adv.报文完;下prep.高于;在...的上方
much	adv.常常;十分
down	prep.往...的下端;沿
after	prep.随...之后;在...后面conj.在...以后
first	adj.第一的;基本的adv.宁可;先
good	adj.好的;正当的
own	adj.自己的n.属于自己的东西v.承认;有
never	adv.不;从不
most	adv.极其;最
old	adj....岁的;老的
shall	aux.将要;一定
day	n.天;昼
where	adv.在哪里;在那里conj.然而;在...处
those	det.那些
come	v.搞;来
himself	pron.他亲自;他自己
way	n.方法;方面
work	n.工作;职业v.经营;工作
life	n.生命;一生
without	adv.外表上;在外面prep.不;无
go	v.对付;忍受
make	n.牌子;体质v.构成;做
well	adj.对的;井的adv.好;很n.好;井v.涌出;流出
through	prep.遍及;从...头至尾
be	v.表示;是
long	adj.长的;长时间的adv.长久;始终v.渴望;归属
say	adv.哎呀;大约n.决定权;细哔叽v.讲述;说
might	n.大量;力量
how	adv.多少;怎样
#am	v.be的第一人称现在时形式
too	adv.很;太
even	adj.均匀的;平的adv.甚至;完全v.使平衡;使平坦
again	adv.到原处;又
many	adj.许多的pron.许多人
back	adj.背后的;边远的adv.往回;向后n.背;缸v.使后退;后退
here	pron.这里
think	v.想;想像
every	det.每一个
people	n.人;人民v.居住于;使充满
same	adj.同样的;同一的
last	adj.最低的;最后的adv.上一次;最后v.度过;楦
away	adv.走吧;走开
under	prep.在...之下
take	n.捕猎;拿v.拿;执住
hand	n.脚;手v.搀扶;交
eye	n.目光;视力v.看;考虑
still	adj.静止的;平静的adv.还是;还要v.静止;渗出
place	n.场所;地方v.放置;得名次
while	conj.虽然;直到v.消磨
just	adj.应得的;正义的adv.刚才;只是
also	adv.也;而且;同样地
young	adj.年轻人的;幼小的
yet	adv.还;迄今;尽管
though	adv.可是;尽管conj.可是;即使
against	prep.对...不利;逆
thing	n.事;物
get	v.获得;取得
ever	adv.总是
give	v.给予;交给
god	n.上帝n.男神;神
year	n.年;年度
off	prep.离...;偏离...
face	n.表面;脸v.面朝;朝
nothing	pron.没有东西
right	adj.合适的;正当的adv.好;正当地n.实况;正当v.补救;纠正
once	adv.一次;一旦conj.一旦...
another	pron.又一个
part	n.一部分;组成部分v.放弃;分开
saw	n.锯;锯床v.锯;锯成
house	n.房屋;棚v.覆盖;住
world	n.世界
head	n.上端;头v.长头;发源
three	n.第三;三
new	adj.新的;新鲜的
love	n.爱;爱情v.爱;恋爱
always	adv.永远;总是
put	v.放;出发
night	n.黑夜;夜
each	adv.对各个pron.各个
king	n.大王;君主
between	adv.在中间prep.联接着...;在...之间
tell	v.吩咐;讲
mind	n.头脑;智力v.记住;照料
heart	n.内心;心
few	adj.很少的;有些pron.很少数;少数
because	conj.因为
thing	n.事;物
whom	pron.谁;他
far	adj.较远的;远的adv.远
seem	v.感到好像;好像发生
look	n.察看;看v.看
call	n.号声;呼叫v.呼唤;叫
whole	adj.全部的;整个的n.全部;统一体
set	n.集子;一套v.放;落
both	adv.在两方面同样地pron.两者
find	n.发现;发现物v.发现;找出
look	n.察看;看v.看
name	n.名字;外号v.把...叫作;给...取名字
day	n.天;昼
let	n.出租;租户v.使;允许
lord	n.主;君主;领主v.称...为勋爵;指挥
country	n.地区;国
ask	v.问
going	adj.成功的;去的n.地面状况;去
#better	adv.多;更好地v.超过;改善good的比较级
home	adv.在家;在家乡n.家;家庭v.回家;有家
side	n.边;旁边v.同意;赞助
something	pron.某;某物
moment	n.片刻;时机
father	n.父;父亲v.生
among	prep.被...所环绕;系...中之一
course	n.进行;行动方向v.追;跑
hands	n.拥有;控制
woman	n.成年女子;女人
enough	adj.足够的adv.够了;很
word	n.词;话v.通知;讲话
mother	n.继母;母v.生;产生醋母
soon	adv.不久;早
full	adj.彻底的;满的
end	n.端;终止v.结束;胜过
room	n.房间;一套房间v.占一房间
almost	adv.几乎
small	adj.细小的;小的n.狭窄部分;小件物品
water	n.矿泉水;水v.喷淋;饮水
want	n.缺乏;需要v.缺乏;要
however	adv.不管怎样;究竟怎样
light	adj.淡色的;轻的adv.轻装地n.光;光感v.点;照亮
quite	adv.很;完全
nor	adv.也不
word	n.词;话v.通知;讲话
whose	det.谁的
door	n.门;门状物
turn	n.翻动;旋动v.翻动;旋动
doe	n.雌鹿
use	n.用;用途v.发挥;用
morning	n.初期;破晓
myself	pron.我亲自;我自己
until	prep.向;在...之前conj.在...以前;直到...时
since	adv.从那以后;之前prep.自...以来conj.因为;自...以来
power	n.力;能力v.促进
themselves	pron.他们亲自;他们自己
us	n.美国pron.人们;我们
rather	adv.宁可;有几分
present	adj.出席的;现在的n.现在;礼物v.表示;提出
voice	n.禽鸣声;说话声v.给...整音;说
other	adj.别的;不同的n.对立的事物
white	adj.白色的;无血色的n.白色;纯洁
work	n.工作;职业v.经营;工作
less	adj.较小的adv.较小地
money	n.财产;货币
next	adj.紧邻的;居后的adv.接下去;下次
poor	adj.贫乏的;贫穷的
death	n.灭亡;死
form	n.模型;形体v.构成;形成
within	adv.户内;内心prep.在...里面;在...之内
together	adv.到一起;同时
till	prep.及于;在...以前conj.在...以前;直到...为止
large	adj.大的;开阔的
matter	n.实体;事情v.化脓;要紧
kind	adj.和蔼的;友好的n.类;种类
often	adv.常常;通常
certain	adj.固定的;可靠的
herself	pron.她亲自;她自己
year	n.年;年度
friend	n.朋友;赞助者
half	n.半;半场
order	n.次序;整齐v.命令;整理
round	adj.丰满的;圆的n.圆圈;圆形物prep.围绕;向...各处v.变圆;环行
true	adj.纯正的;真的adv.纯种地;真实地v.装准
anything	pron.任何事物
keep	n.保持;供养v.保管;保守
wife	n.妇人;妻子
mean	adj.卑鄙的;低劣的n.平均;中间v.意味着;意指
believe	v.认为;想
pass	n.境况;通过v.超过;经过
near	adj.近的;近似的adv.近;近似地prep.靠近v.靠近
public	adj.公开的;公众的n.公众;一群人
state	n.心情;形态v.陈述;确定
son	n.儿子;女婿
hundred	n.第一百;一百
thus	adv.如此;因此;迄今为止
hope	n.希望v.希望;相信
alone	adj.单单;单独的adv.单独地;仅仅
above	adj.上面出现过的adv.在顶部;在上面prep.多于;高于
case	n.框;箱v.探察
dear	adj.可爱的;亲爱的adv.非常;呵n.可爱人;亲爱的
say	adv.哎呀;大约n.决定权;细哔叽v.讲述;说
person	n.家伙;人
high	adj.高的;高地的adv.高;高价的n.高地;高峰
city	n.城市;全市居民
already	adv.马上;已经
received	adj.被普遍接受的
fact	n.事实;细节
girl	n.女孩子;女仆
hear	v.听;听见
time	n.时间;时刻v.调准;为...定时
least	adj.最少的adv.最少n.最少量
perhaps	adv.或许
sure	adj.可靠的;确信的adv.当然;无疑
indeed	adv.哦;确实
open	adj.开着的;空旷的n.旷野;露天v.开;开辟
body	n.躯干;肉体
itself	adv.究竟pron.它自己;自身
along	prep.沿着;依照
land	n.地产;陆地v.靠岸;落下
return	n.回;送回v.回报;回
leave	n.告别;许可v.丢弃;经过
air	n.空气;天气v.晾;晾
nature	n.大自然;禀性
answer	n.答案;反应v.回应;回击
either	adv.也pron.任何一个
law	n.法律;法制
help	n.帮助;补救办法v.帮助;助
lay	adj.世俗的;外行的n.层;歌曲v.置放;产卵
point	n.尖;尖形部件v.显示;指
child	n.小孩;婴儿
letter	n.信;字母v.在...上刻字
four	n.四;匍匐
wish	n.请求;希望v.但愿;祝
fire	n.电炉;火v.烧制;发热
speak	v.讲;说
number	n.数目;算术v.把...编号;计数
therefore	adv.因此
hour	n.时间;小时
friend	n.朋友;赞助者
free	adj.自由的adv.免费地;松开着v.使摆脱;使自由
war	n.斗争;战斗v.击败;斗争
during	prep.在...期间的某一时候
several	pron.几个
business	n.交易;职业
whether	conj.是...;是否
manner	n.方式;态度
second	adj.次要的;第二的adv.第二;以第二位n.秒;片刻v.赞成;支持
reason	n.理由;理智v.劝喻;讨论
unit	n.单位;股份单位
call	n.号声;呼叫v.呼唤;叫
general	adj.笼统的;全体的n.将军;上将
why	adv.为什么
behind	adv.在背后;在过去n.后卫;屁股prep.落后于;在...后面
john	n.厕所;男人
become	v.适合;变成
dead	adj.不动的;死亡的adv.全然地;直接地
earth	n.尘世;地球v.把...接地;用土掩盖
boy	n.男孩;男子
forth	adv.往外;向前
thousand	n.第一千;一千
look	n.察看;看v.看
family	n.户;家
soul	n.精神;灵魂
feel	n.触;触觉v.触;发觉
England	n.英格兰
spirit	n.精神;灵魂v.鼓励;偷偷地走
question	n.难题;问题v.怀疑;问
care	n.小心;忧虑v.喜欢;关心
truth	n.实情;事实
really	adv.很;说真的
rest	n.长眠;平静v.长眠;休息
mean	adj.卑鄙的;低劣的n.平均;中间v.意味着;意指
different	adj.差异的;各别的
possible	adj.可能的
fell	adj.残暴的;剧痛的n.折缝;山v.缝;击倒
towards	prep.对;向
human	adj.人的;似人类的n.人
short	adj.矮的;短的adv.唐突地;突然地n.短路;要点v.卖空;短路
town	n.城市;镇
follow	v.跟随;伴随
need	aux.须要n.缺少;需要v.缺少;需要
cause	n.理由;事业v.使;使产生
evening	n.傍晚;后期
return	n.回;送回v.回报;回
five	n.五
strong	adj.极大的;强壮的adv.强烈地;强有力地
able	adj.得以...的
live	adj.活的;真的adv.在现场v.过;活
lady	n.贵妇人;女士
subject	adj.臣服的;需要...的n.题目;学科v.使臣服;提供
answer	n.答案;反应v.回应;回击
sea	n.海;内海
fear	n.害怕;可能性v.害怕;恐怕
understand	v.得知;理解
hard	adj.坚硬的;紧的adv.坚硬地;困难地
terms	n.条件;细则v.接受;妥协
doubt	n.迟疑;怀疑v.怀疑;迟疑
around	adv.兜着圈子;在周围prep.环绕;在...各处
ask	v.问
arm	n.臂;军种v.提供;武装起来
turn	n.翻动;旋动v.翻动;旋动
sense	n.感官;感觉v.检测;了解
seem	v.感到好像;好像发生
black	adj.黑暗的;黑色的n.黑色v.变黑
bring	v.促使;出产
follow	v.跟随;伴随
beautiful	adj.出色的;美的
close	adj.紧的;近的adv.接近地n.结束;终止v.关;关
dark	adj.黑暗的;深黑n.黑色;黑暗
hold	n.拿;船舱v.表现;掌着
character	n.品德;性质
sort	n.性质;种类v.拣出;符合
sight	n.检查;看见;视觉v.观测;看到
ten	n.第十;十
show	n.演出;展览v.陈列;给...看
party	adj.共有的;政党的n.党;队;聚会
fine	adj.快的;美好的adv.很;细小地n.罚金;租费v.使纯;变纯
ready	adj.快要...的v.使准备好;准备好
story	n.情节;小说
common	adj.公共的;普通的n.共用牧地
book	n.卷;书v.预订;预订
electronic	adj.电子的
talk	n.讲话;闲话v.讲;谈论
account	n.记述;解释v.报帐;导致
mark	n.马可福音;马可n.短线;符号v.标明;评分
interest	n.利益;趣味v.使参与;使感兴趣
bed	n.床;卧室v.睡;性交
necessary	adj.必然的;必要的
age	n.成年;年龄v.使老;变陈
else	adv.否则;其他
force	n.力;武力v.强迫;逼叫
idea	n.计划;思想
longer	adj.较长
art	n.美术;艺术
spoke	n.辐条
across	prep.穿过...;与...相交叉
brother	n.兄弟;挚友
early	adj.早的;早期的adv.从前;早
ought	v.欠;占有
sometimes	adv.以前;有时
line	n.纹路;线v.出局;填
say	adv.哎呀;大约n.决定权;细哔叽v.讲述;说
table	n.一桌酒菜;桌子v.把...列表
appear	v.出现;露面
river	n.河;巨流
eye	n.目光;视力v.看;考虑
sun	n.恒星;日光v.晒;晒太阳
#later	adv.后来;再见late的比较级
everything	pron.每件事;一切
reach	n.地带;伸出v.到达;伸出
sudden	adj.突然的;迅速的
hour	n.时间;小时
strange	adj.陌生的;外地的
deep	adj.深的;有...深的adv.强烈地;深深地n.海;海渊
change	n.改变;更动v.改变;换去
mile	n.英里
feel	n.触;触觉v.触;发觉
act	n.幕;行为v.扮演;演
meet	n.集合;集会v.接;遇见
#further	adv.此外;更远地v.促进far的比较级
purpose	n.目的;效用
happy	adj.乐意的;愉快的
add	v.添加;做加法
seem	v.感到好像;好像发生
blood	n.血;血统
rose	n.玫瑰;玫瑰色;玫瑰香水
south	adj.南部的;在南方的adv.向南方n.南;南部
beyond	prep.迟于;深于
cold	adj.感觉冷的;冷的adv.突然地;完全地n.感冒;冷
neither	adv.也;也不pron.无一个
forward	adj.热心的;早的adv.提前地;向前n.前锋v.促进;发送
view	n.观看;视力v.查看;观看
position	n.恰当位置;位置v.安放;驻扎
sound	adj.健康的;牢固的n.声;音v.宣告;发音
none	pron.没有一个;没有一人
enter	v.参加;登记
clear	adj.纯色的;清晰的adv.离开着;完全v.扫清;变晴
road	n.街道;路
late	adj.迟的;晚的adv.迟;晚
stand	n.停住;站立v.经受;容忍
suppose	v.猜想;假定
daughter	n.女儿;女性后裔
real	adj.逼真的;真的
nearly	adv.极;几乎
mine	n.矿;矿藏pron.我的v.采;开矿
law	n.法律;法制
knowledge	n.熟悉;知识
come	v.搞;来
bad	adj.坏的;顽皮的
cut	n.切;切口v.切;凿
copy	n.本;原件v.抄袭;抄写
husband	n.夫;管家v.持有;使有丈夫
six	n.第六;六
France	n.法兰西
peace	n.和平;和约
low	adj.低的;浅的adv.低;低声地
north	adj.北部的;在北方的adv.向北方n.北;北方
remember	v.记得;牢记
effect	n.感受;结果v.产生;使发生
natural	adj.有关自然的n.智力低下的人
pretty	adj.妙的;漂亮的
fall	n.降落;落下v.砍倒;跌倒
fair	adj.公正的adv.公正地;正面地n.美;女人
service	n.服务v.检修;为...服务
below	adv.在楼下;在下面prep.低于;在...下面
except	prep.除...外conj.除非;除了v.把...除外;反对
hair	n.毛;头发
pass	n.境况;通过v.超过;经过
copyright	n.版权v.以版权保护
do	v.做
army	n.军队;陆军
run	n.跑步;赛跑v.跑;逃
horse	n.马;骑兵v.发情;上马
future	n.将来;前途
open	adj.开着的;空旷的n.旷野;露天v.开;开辟
pleasure	n.高兴;娱乐v.使高兴;觉得高兴
history	n.过去;历史
west	adj.西部的;西方的adv.向西方n.西;西部;西方
pay	n.报偿;付钱v.付;付款
red	adj.红的;通红的n.红;红球
note	n.按语;短笺v.记录;注意
although	conj.虽然;尽管
want	n.缺乏;需要v.缺乏;要
gold	n.金;金币
make	n.牌子;体质v.构成;做
desire	n.要求;愿望v.渴望;要求
play	n.比赛;玩v.开;玩
master	n.艺术家;主人v.精通;统治
office	n.办公室;处
front	adj.前面的;正面的n.前面;正面v.对抗;面向
big	adj.大的;洪亮的adv.成功地;大量地
certainly	adv.当然;无疑地
wind	n.风;圈;气息v.包;绕
receive	v.得到;收到
attention	n.考虑;注意
government	n.政府;政体
church	n.礼拜;礼拜堂
strength	n.力;强度
length	n.长;长段
company	n.公司;群
paper	n.文件;纸v.用纸包起;贴糊墙纸
letter	n.信;字母v.在...上刻字
probably	adv.很可能
glad	adj.高兴的;乐意的
important	adj.重要的;自负的
especial	adj.亲近的;特别的
yourself	pron.你亲自;你自己
fellow	n.男人;人
bear	n.玩具熊;熊v.忍;压
opinion	n.评价;意见
window	n.窗;窗框
faith	n.信任;信条
ago	adv.以前
agreement	n.达成协议;协定
charge	n.价钱;应付v.要;冲锋
beauty	n.美;美人
lip	n.唇状物;嘴唇
remain	v.留下;剩余
arm	n.臂;军种v.提供;武装起来
latter	adj.后者的;较后的
duty	n.责任;职责
send	v.发送;派遣
distance	n.进展;远v.使远离;远远超过
silence	n.寂静;静默v.使安静;压制
foot	n.脚;最下部v.步行;结算
wild	adj.野生的;原始的adv.狂暴地n.野生动物
object	n.对象;物体v.提出;反对
die	n.板牙;模具v.遭受;死
save	prep.除...外v.储蓄;救助
gentleman	n.先生
tree	n.木制用具;树v.在...上植树;爬上树
green	adj.绿色的n.绿色;绿色物v.欺骗;成为绿色
trouble	n.烦恼;困难v.麻烦;折磨
smile	n.欢快;微笑v.露出;惠及
book	n.卷;书v.预订;预订
wrong	adj.不道德的;错误的adv.不适当地;错误地n.错误;坏事v.使丢脸
various	adj.不同的;各个的
sleep	n.昏睡;睡眠v.供...睡觉;睡
person	n.家伙;人
happen	v.发生;碰巧
particular	adj.特定的;特殊的n.详情;一项
minute	adj.快熟的;微小的n.分
hardly	adv.不十分;几乎不
walk	n.行走路程;走v.走遍;走
chief	adj.为首的;主要的n.酋长;首领
chance	adj.偶然的n.机会;机缘v.冒...的险;碰巧
accord	n.谅解;谐和v.授予;相符合
action	n.行动;行为
deal	n.待遇;交易v.发;分配
visit	n.参观;视察v.访问;视察
think	v.想;想像
follow	v.跟随;伴随
stand	n.停住;站立v.经受;容忍
know	v.记住;确知
try	n.尝试v.试;试图
presence	n.出席;进见
heavy	adj.太贵的;重的n.肥畜;重的人
sweet	adj.甜的;悦耳的n.甜食;甜味
plain	adj.单色的;朴素的n.平原;平针
donation	n.捐赠;捐赠物
immediate	adj.立即的;直接的
mouth	n.口;人v.说;做鬼脸
rich	adj.富的;富饶的
month	n.月
afraid	adj.恐惧的;遗憾的
single	adj.单程的;单人的n.单曲唱片;一个v.选出
joy	n.成功;欢欣v.享受;高兴
enemy	n.敌国;敌军
unless	conj.除非
state	n.心情;形态v.陈述;确定
ship	n.船;飞船v.用船运;上船
condition	n.健康状况;状况v.使健康;训练
carry	n.射程;运载v.提;携带
exclaim	v.大声说出;呼喊
fill	n.充分;装填物v.挤满;装满
see	v.察看;看
influence	n.势力;影响v.影响
write	v.记述;写
boy	n.男孩;男子
appear	v.出现;露面
outside	n.外表;外面prep.除了;在...的外面
secret	adj.秘密的;能保密的n.奥秘;秘密
part	n.一部分;组成部分v.放弃;分开
please	adv.请;行v.乐于;敬请
appearance	n.出版;出现
evil	adj.讨厌的;邪恶的n.坏事;祸害
march	n.三月n.行军;边界v.进展;前进
whatever	pron.不管什么;诸如此类
slow	adj.耗时的;慢的adv.慢慢地v.放慢;放慢速度
tear	n.悲痛;撕v.流泪;撕
horse	n.马;骑兵v.发情;上马
place	n.场所;地方v.放置;得名次
stay	n.逗留;停止v.停止;延迟
instead	adv.反而;作为替代
blue	adj.悲伤的;蓝色的n.蓝色;蓝颜料
impossible	adj.不可能的
period	n.纪;时间
sister	n.姐妹
battle	n.格斗;竞赛v.搏斗;作战
school	n.上学;学校v.教育;控制
occasion	n.时机;时刻v.引起
former	adj.前任的;以前的
food	n.食物;养料
youth	n.青年时期;青年人
learn	v.发现;学
merely	adv.纯粹地;仅仅
reach	n.地带;伸出v.到达;伸出
system	n.系统;制度
twenty	n.第二十;二十
dinner	n.客饭;宴会
quiet	adj.安静的;寂静的n.安静;安宁v.确认;使安静
easily	adv.容易地;无疑
afterwards	adv.以后
walk	n.行走路程;走v.走遍;走
laugh	n.笑;笑柄v.开颜;笑
language	n.全部词汇;语言
expression	n.表达;表示
week	n.工作周;星期
hall	n.会堂;酒
danger	n.危险;危险示意
property	n.财产;地产
wonder	n.惊奇;奇迹v.感到惊讶;感到疑惑
usual	adj.通常的
figure	n.价格;数字v.计算;出现
court	n.法庭;球场v.招致;求爱
general	adj.笼统的;全体的n.将军;上将
show	n.演出;展览v.陈列;给...看
ancient	adj.古代的;古老的n.古钱;旗帜
respect	n.敬意;尊敬v.关于;敬意
third	n.第三;三分之一
worth	adj.值钱的n.价值;经济价值prep.具有...价值;拥有...财产
simple	adj.纯朴的;简单的
tree	n.木制用具;树v.在...上植树;爬上树
remain	v.留下;剩余
society	n.阶层;社会
fight	n.战斗;争吵v.打;奋斗
wall	n.壁;墙v.给...建墙;转动
result	n.获胜;结果v.发生;结果
heaven	n.上天;天
start	n.惊跳;开始v.出现;惊动
command	n.命令;指挥v.俯临;命令
tone	n.音;语气v.增强;调和
regard	n.关系;敬爱v.敬爱;看待
expect	v.等待;预计
mere	adj.纯粹的;只不过的
month	n.月
beside	prep.和...相比;在...旁边
silent	adj.安静的;不作声的
perfect	adj.完好的;完美的v.使精通;使完美
experience	n.经历;经验v.经历
street	n.街;街区
entire	adj.单一的;全部的
fresh	adj.另外的;新的
duke	n.公爵;双手
cover	n.书壳;掩蔽v.盖;代替
east	adj.东部的;在东方的adv.向东方n.东;东部;东方
wood	n.木;木材
stone	n.界石;磨石v.向...扔石块;用石铺
quick	adj.聪敏的;快的adv.紧身地;快n.活肉
notice	n.警告;关注;征象v.警告;提到
bright	adj.聪明的;明亮的adv.光亮地
Christ	n.基督;弥赛亚
boat	n.船v.用船装运;乘船
noble	adj.高尚的;光辉的n.工贼头目;贵族
somewhat	adv.有点
sudden	adj.突然的;迅速的
value	n.价格;价值v.夸耀;尊重
direction	n.管理;指示
chair	n.椅子;主席v.使入座
due	adj.欠款的;应给的adv.正对着n.应缴款;责任
support	n.帮助;支撑v.帮助;支持
date	n.日期;时期v.过期;注有日期
wait	n.等待;幕间时间v.等待;等
Christian	adj.基督的n.基督徒;人
village	n.居民村;乡村
live	adj.活的;真的adv.在现场v.过;活
agree	v.承认;表示同意
line	n.纹路;线v.出局;填
consider	v.考虑;认为
field	n.场地;田v.接;派...上场
scarcely	adv.刚刚;决不
wish	n.请求;希望v.但愿;祝
wait	n.等待;幕间时间v.等待;等
permission	n.允许
success	n.成功;发迹
piece	n.件;片v.接;拼合
form	n.模型;形体v.构成;形成
speaking	n.说话adj.说话的
try	n.尝试v.试;试图
proper	adj.本来的;适宜的
hill	n.小山;斜坡
music	n.音乐;音乐伴奏
German	adj.德国的;德国人的n.德国人;德语
afternoon	n.后期;下午
cry	n.叫喊;哭v.哭;鸣
cost	n.代价;价钱v.价钱为;使付出
allow	v.允给;允许
girl	n.女孩子;女仆
broke	adj.不名一文的
seven	n.第七;七
private	adj.私立的;私人的n.平民;士兵
sit	v.骑;坐
news	n.消息;新闻
top	adj.顶的;最高的n.顶;盖v.盖;结束
scene	n.地点;一场
discover	v.发现;显露
marriage	n.结婚;结婚仪式
step	n.步;步态v.跨;踩
garden	n.公园;花园v.用花园点缀
race	n.比赛;族v.疾走;猛转
begin	v.开始
per	prep.按照;每
individual	adj.独特的;个别的n.个人;人
learn	v.发现;学
political	adj.国家的;政党的
difficult	adj.困难的;难懂的
speech	n.说话;说话方式
lie	n.谎言;躺v.说谎;平卧
cast	n.撒网;投v.投
eat	v.吃;咬
authority	n.当局;权
floor	n.层;底v.击败
ill	adj.不利的;坏的n.病;坏
way	n.方法;方面
officer	n.船长;法警
offer	n.发价;给予v.给予;提出
original	adj.起初的n.原型;原作
happiness	n.恰当;幸福
flower	n.花;精华v.发育;开花
summer	n.夏;大梁v.夏季放牧;过夏天
provide	v.供给;规定
study	n.学科;学习;研究v.记住;学习;研究
religion	n.宗教;宗教教育
picture	n.画v.绘;映出
wall	n.壁;墙v.给...建墙;转动
personal	adj.个人的;亲自的
America	n.美洲
watch	n.手表;守卫v.保卫;等待
leave	n.告别;许可v.丢弃;经过
hot	adj.辣的;热的
effort	n.努力;全部努力
escape	n.逃路;逃跑v.逃脱;漏出
attempt	n.攻击;企图v.企图;引诱
kill	n.击落;杀死v.冻死;杀死
fast	adj.快的adv.快n.禁食;禁食期v.节制饮食;禁食
author	n.发起人;著作者v.发起;著作
brown	adj.肤色深的;棕色的n.棕色v.呈现棕色
pain	n.痛;痛苦
spring	n.弹性;反弹;春天v.惊起;跳
take	n.捕猎;拿v.拿;执住
soldier	n.军事家;士兵
house	n.房屋;棚v.覆盖;住
beneath	adv.在较低处;在下prep.在...底下;在...下方
talk	n.讲话;闲话v.讲;谈论
turning	n.旋转;转弯处
century	n.一百分;百人
step	n.步;步态v.跨;踩
intend	v.想要;意指
soft	adj.轻的;柔滑的adv.柔软地;嘘
straight	adj.整齐的;直的adv.立即;直
matter	n.实体;事情v.化脓;要紧
likely	adj.合适的;可信的adv.很可能
corner	n.包角;角v.垄断;转弯
trademark	n.标记;商标v.用商标标明
justice	n.公正;正确
simply	adv.简单地;仅仅
produce	n.产品;成果v.生;生产
trust	n.信任;信心v.想;信任
appear	v.出现;露面
laugh	n.笑;笑柄v.开颜;笑
forget	v.忘;健忘
Europe	n.欧罗巴洲
passage	n.经过;迁移;通道;走廊
eight	n.八;第八
ourselves	pron.我们亲自;我们自己
give	v.给予;交给
dress	n.衣服;装饰v.布置;穿衣
pass	n.境况;通过v.超过;经过
terrible	adj.可怕的;困难的
medium	adj.中间的n.媒质;手段;巫师
effort	n.努力;全部努力
sake	n.理由;目的
breath	n.呼吸;气息
wise	adj.聪明的;了解的v.教导;知道
possession	n.拥有;有
pleasant	adj.活泼的
perfect	adj.完好的;完美的v.使精通;使完美
memory	n.回忆;记忆
usual	adj.通常的
grave	adj.暗淡的;低沉的n.墓碑;墓穴
fix	n.方位;困境v.定居;固定
modern	adj.近代的;现代化的n.近代
spot	n.疤点;点子v.使有污渍;玷污
troop	n.军队;一群v.成群结队;作伴
rise	n.岗;上涨v.登上;离席
break	n.破裂;破晓v.打破;破坏
fifty	n.第五十;五十
island	n.岛;岛状物
meet	n.集合;集会v.接;遇见
camp	n.兵营;拘留所v.临时安顿;搞同性恋
nation	n.国家;国民
existence	n.存在;发生
reply	n.驳复;回答v.回答;反响
sky	n.苍天;天
touch	n.触;触觉v.触摸;触摸
equal	adj.平等的;平均的n.匹敌者;同等的人v.比得上;相等
fortune	n.富有;好运
shore	n.滨;陆地
domain	n.产业;领土
situation	n.情况;位置
look	n.察看;看v.看
promise	n.可能;允诺v.向...保证;允诺
order	n.次序;整齐v.命令;整理
degree	n.程度;度
middle	adj.中部的;中等的n.中部;中等货
winter	n.冬;寒冷天气v.过冬
plan	n.方法;计划v.计划;设计
allow	v.允给;允许
pale	adj.苍白的;浅的n.尖板条;界限v.使苍白;包围
conduct	n.处理;举止v.表现;处理
religious	adj.宗教的
surprise	n.惊奇;突然袭击v.撞见;惊奇
minute	adj.快熟的;微小的n.分
case	n.框;箱v.探察
lead	n.指引;铅v.牵;致使
move	n.搬家;动v.动;调动
name	n.名字;外号v.把...叫作;给...取名字
stop	n.停止;阻塞v.停止;阻塞
#worse	adv.更坏;更猛烈地bad的比较级
glass	n.玻璃;镜子v.反射;给...装玻璃
board	n.板;纸板v.使搭伙;搭伙
vain	adj.徒劳的;自负的
affair	n.事;事情
instance	n.例子;情况v.举...为例;举例
safe	adj.安全的;谨慎的n.保险箱;家用冰箱
loss	n.减少;损失
doctor	n.巫医;医生v.修改;修理
offer	n.发价;给予v.给予;提出
class	n.班级;课
complete	adj.十足的;完成的v.使完美;完成
access	n.接近;通道v.存取;接近
#lower	v.放下;减低low的比较级
repeat	n.复写;重复v.复述;重复
form	n.模型;形体v.构成;形成
darkness	n.黑暗;无知
military	adj.军人的;军事的n.军人;武装部队
warm	adj.感到热的;温暖的v.取暖;同情
drink	n.喝酒;饮料v.喝
passion	n.激怒;激情
one	n.一;一体
physical	adj.物理的;物质的n.体格检查
example	n.范例;例题
ear	n.耳;穗
question	n.难题;问题v.怀疑;问
start	n.惊跳;开始v.出现;惊动
keep	n.保持;供养v.保管;保守
spite	n.不幸;恶意v.恶意对待
direct	adj.笔直的;直接的adv.径直地v.管理;指示
serious	adj.认真的;严肃的
hat	n.贿赂;帽子
dog	n.公狗;狗v.跟踪;困扰
silver	n.钱;银v.镀银于;变成银色
sufficient	adj.自负的;足够的
main	adj.辽阔的;完全的n.体力;叫数
mention	n.传令嘉奖;提及v.传令嘉奖;提到
servant	n.雇员;仆人
pride	n.骄傲;自豪v.使得意;自豪
crowd	n.群;群众v.挨;挤
train	n.连串;列车v.把...对准;训练
wonderful	adj.精彩的
moral	adj.道德的;有道德的n.典型
instant	adj.紧急的;立即的n.时刻;瞬息
path	n.道路;路
mean	adj.卑鄙的;低劣的n.平均;中间v.意味着;意指
fit	adj.健康的;适合的n.合身;配合v.配合;适合
order	n.次序;整齐v.命令;整理
lot	n.抽签;签
enter	v.参加;登记
rule	n.裁决;规则v.控制;统治
sword	n.剑;权力象征
attack	n.攻击;侵蚀v.攻击
seat	n.坐部;座v.供给...座位;使坐下
game	adj.猎物的;跛的n.游戏;运动v.赌掉;赌博
health	n.健康;卫生
paragraph	n.短文;段落v.写短文
statement	n.陈述;声明
social	adj.社会的n.社会保险;社交聚会
refund	n.退还;退款v.退还
sorry	adj.难过的;内疚的
courage	n.勇敢
member	n.成员;子句
grace	n.风度;善意v.给...增光;使优美
official	adj.公职的;正式的n.官员;行政人员
dream	n.出神;梦v.做;想
worthy	adj.有价值的;值得的n.知名人士
rock	n.大石;矿石v.轻摇使;轻摆
jack	n.老兄;男人v.提高;用篝灯猎
special	adj.特殊的;异常的n.特刊;专列
request	n.需要;要求v.要求
mighty	adj.巨大的;强大的adv.很
glance	n.擦过;闪光v.擦过;反射
head	n.上端;头v.长头;发源
movement	n.动;动作
fee	n.采邑;费
share	n.股份;一份v.分开;分享
expect	v.等待;预计
dollar	n.美元;一元银币
spread	n.翼展;展开v.撒;涂
opposite	adj.对面的;反对的adv.在对面n.对边;对立物prep.在...的对面
glory	n.光荣;赞颂v.吹嘘;骄傲
twelve	n.第十二;十二
space	n.场地;空间v.分隔开;留间隔
engaged	adj.被占用的;忙的
peter	v.逐渐减少
wine	n.葡萄酒;药酒v.喝酒
ordinary	adj.平常的;平庸的n.常任法官;寻常
mountain	n.山;山脉
taste	n.尝;味v.尝;吃
iron	n.铁;熨斗v.熨;熨衣
distribute	v.分;分发
trade	n.交易;贸易v.对换;购物
consider	v.考虑;认为
great	adj.大的;久的n.大人物
accept	v.承认;接受
advantage	n.好处;有利地位v.有利于;获利
idea	n.计划;思想
us	n.美国pron.人们;我们
officer	n.船长;法警
rate	n.比率;费率v.呵责;骂走
clothe	v.覆盖;赋予
sign	n.标志;符号v.签;写下
native	adj.出生的n.当地人;土人
judge	n.法官;鉴定人v.裁决;断定
difference	n.差别;特点
work	n.工作;职业v.经营;工作
anxious	adj.焦虑的
marry	v.娶;结婚
captain	n.船长;领袖v.率领
finish	n.结束;抛光v.结束;用完
extent	n.范围;广度
watch	n.手表;守卫v.保卫;等待
curious	adj.好奇的;奇特的
foreign	adj.对外的;外国的
besides	adv.此外;而且prep.除...之外
method	n.方法;条理
excellent	adj.非常的;较高的
confidence	n.信任;信心
marked	adj.明显的;有标记的
exactly	adv.精确地;正
importance	n.重要;自大
final	adj.决定性的;最后的n.决赛;期终考试
bill	n.清单;帐单v.爱抚;接吻
vast	adj.大量的;高大的
prove	v.表现;证明
fancy	adj.别致的;特级的n.任性;设想v.相信;想象
quick	adj.聪敏的;快的adv.紧身地;快n.活肉
yes	adv.不对;是n.是;赞成票
prevent	v.防止;先去
neck	n.颈肉;颈项v.割颈杀;变狭
heart	n.内心;心
liberty	n.释放;许可
interest	n.利益;趣味v.使参与;使感兴趣
side	n.边;旁边v.同意;赞助
legal	adj.法律的;合法的
dry	adj.干的;干燥的v.使干;变干
serve	n.发球;轮到发球v.任;帮佣
aside	adv.离开;撇开n.离题的话;旁白
pure	adj.纯粹的;纯净的
concerning	prep.关于
lose	v.失去;遗失
power	n.力;能力v.促进
possess	v.具有;拥有
evidence	n.根据;迹象v.显示;证明
distant	adj.冷淡的;远的
progress	n.进步;前进v.改进;前进
similar	adj.相似的;相像的
narrow	adj.勉强的;狭的n.狭谷;狭窄部分v.变狭;缩小
altogether	adv.完全;总共
build	n.体形;构造v.构成;建设
page	n.记录;页v.翻阅;侍侯
particular	adj.特定的;特殊的n.详情;一项
know	v.记住;确知
week	n.工作周;星期
hold	n.拿;船舱v.表现;掌着
mountain	n.山;山脉
search	n.检查;搜查v.探;细察
sad	adj.悲哀的;可悲的
sin	n.过错;罪v.犯;犯过失
lie	n.谎言;躺v.说谎;平卧
proud	adj.感到自豪的
pieces	n.身心崩溃v.拆开
clear	adj.纯色的;清晰的adv.离开着;完全v.扫清;变晴
price	n.贿金;价格v.给...定金;定金
ship	n.船;飞船v.用船运;上船
thirty	n.第三十;三十
sick	adj.病人的;恶心的v.使厌恶
honest	adj.诚实的;真诚的
shut	v.关上;合上
talk	n.讲话;闲话v.讲;谈论
bank	n.岸;堆v.开银行;做庄家
fate	n.命运;天命
judgment	n.判断;审判
condition	n.健康状况;状况v.使健康;训练
accept	v.承认;接受
hill	n.小山;斜坡
forest	n.林区;一丛
measure	n.尺寸;量度v.打量;量
species	n.种;种类
seek	v.试图;去
otherwise	adv.别样;不然
stream	n.河;流v.流;飞奔
honor	n.名誉;荣誉v.使增光;尊敬
careful	adj.关切的;精确的
obtain	v.持有;达到
ear	n.耳;穗
bread	n.面包;食物
bottom	adj.底部的;基础的n.底;枯谷v.使基;基于
additional	adj.添加的
present	adj.出席的;现在的n.现在;礼物v.表示;提出
aid	n.帮助;外援v.帮助
finger	n.手指;指状物v.指出;伸出
remember	v.记得;牢记
choose	v.情愿;欲;挑选
animal	n.动物;畜
event	n.结果
delight	n.高兴;可爱性v.使高兴;感到高兴
right	adj.合适的;正当的adv.好;正当地n.实况;正当v.补救;纠正
amount	n.量;总数v.等同;合计
obtain	v.持有;达到
tax	n.负担;税v.对...收会费;对...征税
servant	n.雇员;仆人
son	n.儿子;女婿
cross	adj.交叉的;相互的adv.横跨地n.十字架v.穿过;交叉
shoulder	n.肩;肩部v.担负;肩起
thick	adj.厚的;密的n.傻瓜
point	n.尖;尖形部件v.显示;指
stranger	n.陌生人
wood	n.木;木材
fact	n.事实;细节
dare	n.大胆;挑战v.敢;敢做
grow	v.种;长
creature	n.人;生物
rain	n.一阵;雨v.下;诉苦
false	adj.不诚实的;不正确的
tall	adj.长的;高的
gate	n.大门;路v.给...装门;用门控制
nation	n.国家;国民
quiet	adj.安静的;寂静的n.安静;安宁v.确认;使安静
surface	n.表面;地面v.使公开化;变得清醒
freely	adv.直爽地;自由地
holy	adj.神圣的;圣洁的
street	n.街;街区
blow	n.吹;花v.吹;吹响
regard	n.关系;敬爱v.敬爱;看待
fashion	n.方式;上流社会v.改变;制作
report	n.报道;报告v.报道;说
coast	n.海岸;滑行v.绕...而行;滑行
daily	adj.每日的;一天的adv.每日n.女佣;日报
file	n.文件夹;锉刀v.发送;锉
shoulder	n.肩;肩部v.担负;肩起
face	n.表面;脸v.面朝;朝
succeed	v.接替;成功
bird	n.鸟;幼鸟
royal	adj.国王的;敕立的n.顶桅帆;王裁
song	n.歌;诗歌
wealth	n.财富;丰富
comfort	n.安慰;盖被v.安慰;帮助
fail	n.不及格;交割失信v.不;缺乏
freedom	n.直爽;自由
peculiar	adj.奇怪的;特殊的
anyone	pron.任何人
advance	adj.先行的;预先的n.前进v.促进;提出
gentle	adj.轻柔的;温和的
sure	adj.可靠的;确信的adv.当然;无疑
animal	n.动物;畜
wait	n.等待;幕间时间v.等待;等
secure	adj.安全的;安心的v.保证;缚牢
grass	n.草;草场
touch	n.触;触觉v.触摸;触摸
draw	n.被拉的量;拉v.拔出;拉
stage	n.舞台;戏剧;阶段v.举办;展现
portion	n.一部分;一份v.把...分给;命定
express	adj.明确的;专门的adv.特意地;用快递n.捷运公司;快车v.表示
open	adj.开着的;空旷的n.旷野;露天v.开;开辟
spirit	n.精神;灵魂v.鼓励;偷偷地走
fish	n.鱼;鱼肉v.捕;捕鱼
tongue	n.舌;语言
capital	adj.首都的;重要的n.首都;资本
angry	adj.发怒的;狂暴的
grow	v.种;长
carriage	n.支架;姿势
weather	n.恶劣天气;天气v.经受风雨;退色
breast	n.胸;胸部v.攀登;以胸撞
presently	adv.不久;当即
snow	n.下雪期;雪v.用雪困住;下雪
paper	n.文件;纸v.用纸包起;贴糊墙纸
necessity	n.必然;必要
practice	n.练习;实践
claim	n.权利;要求v.要求;主张
education	n.教育;教育学
sharp	adj.锋利的;尖的
prince	n.国君;王子
group	n.集体;组v.簇射;形成组
play	n.比赛;玩v.开;玩
throughout	adv.到处prep.遍及
pity	n.可惜;同情v.同情;有同情心
expense	n.花钱;价钱
yours	pron.你的
million	n.百万;许多
add	v.添加;做加法
pray	adv.请v.祈望;做
explain	v.讲解;解释
lead	n.指引;铅v.牵;致使
kill	n.击落;杀死v.冻死;杀死
shadow	n.阴影;影子v.钉...的梢;渐变
companion	n.同伴;职业伴侣
weight	n.重;重量单位v.使负重;使倾斜
mass	n.弥撒;弥撒曲;团v.集中;聚集
establish	v.安置;建立
suffer	v.经受;忍受
gray	n.戈瑞
brave	adj.勇敢的;壮观的n.恶棍;勇敢的人v.向...挑战;吹嘘
thin	adj.薄的;稀薄的;瘦的v.使薄;变薄
check	n.停止;制服v.核对;击退
virtue	n.美德;贞操
golden	adj.含金的;金的
numerous	adj.许多的
frequent	adj.经常的v.常到;交往
famous	adj.第一流的;著名的
tell	v.吩咐;讲
powerful	adj.浓烈的;强壮的
alive	adj.存在的;活着的
waters	n.海域;近海
national	adj.国家的;国民的n.国民;全国总部
weak	adj.不牢固的;虚弱的
divine	adj.敬神的;神的n.神;神学的v.发现;推测
material	adj.身体上的;物质的n.布;材料
principal	adj.主震的;资本的n.为首的人;主要演员
gather	v.收集;积聚
suggest	v.建议;意思是
frank	adj.坦白的n.弗兰克;欧洲人
valley	n.流域;山谷
guess	n.猜测v.猜;想
find	n.发现;发现物v.发现;找出
yellow	adj.发黄的;黄的n.黄;黄色颜料v.使发黄;发黄
heat	n.热;体温v.使热;变热
remain	v.留下;剩余
guard	n.警戒;警卫员v.保守;看守
equal	adj.平等的;平均的n.匹敌者;同等的人v.比得上;相等
natural	adj.有关自然的n.智力低下的人
box	n.箱;巴掌v.打;斗拳
remarkable	adj.非凡的
god	n.上帝n.男神;神
moon	n.月光;月球v.虚度;懒散度日
slight	adj.少量的;纤细的n.冷落;轻视v.忽视;看轻
style	n.派头;样式v.叫
point	n.尖;尖形部件v.显示;指
window	n.窗;窗框
cross	adj.交叉的;相互的adv.横跨地n.十字架v.穿过;交叉
pound	n.磅;镑v.捣碎;剧跳
evident	adj.明显的
principle	n.原则;准则
immediate	adj.立即的;直接的
willing	adj.愿意的
principle	n.原则;准则
character	n.品德;性质
season	n.季;节期v.给...调味;变干燥
remark	n.言辞;注意v.说;注意
science	n.科学;科学事物
tender	adj.嫩的;温柔的n.关怀;交付v.交付;提出
work	n.工作;职业v.经营;工作
whisper	n.低语;微量v.低声说出;低语
interest	n.利益;趣味v.使参与;使感兴趣
quarter	n.四分之一;一刻钟
midst	n.中部prep.在...之中
apparent	adj.表面上的;显然的
bore	n.孔;内膛v.挤出;钻
active	adj.活跃的;积极的n.活跃的人;主动态
aware	adj.懂事的;意识到的
uncle	n.伯父;大伯;舅父
list	n.表;布条v.列举;听
dangerous	adj.引起危险的
august	adj.威严的
calm	adj.安静的;平静的n.安静;镇静v.使平静;平静下来
genius	n.特征;天才
sacred	adj.宗教的
kingdom	n.君主身份;王国
entire	adj.单一的;全部的
popular	adj.民众的
unknown	adj.不知道的n.未知的人;未知元
nice	adj.好的;好看的
habit	n.气质;习惯
familiar	adj.亲近的;熟悉的n.常客;知交
reader	n.读者;教科书
publish	v.出版;发表
direct	adj.笔直的;直接的adv.径直地v.管理;指示
handsome	adj.好看的;慷慨的
join	n.并;连接v.连接;参加
actually	adv.竟然;如今
king	n.大王;君主
post	n.柱;岗位v.宣布;押
approach	n.进路;近似v.近似;靠近
hear	v.听;听见
need	aux.须要n.缺少;需要v.缺少;需要
walk	n.行走路程;走v.走遍;走
twice	adv.两倍;两次
throw	n.冒险;投掷v.发射;投
appoint	v.任命;下令
wisdom	n.明智;知识
number	n.数目;算术v.把...编号;计数
demand	n.需要;要求v.强要;询问
priest	n.祭司;司铎
sorrow	n.悲伤;悔憾v.哀痛;懊悔
drive	n.驾驶;紧迫v.逼迫;赶
fault	n.错误;缺点v.产生断层;犯错误
listen	v.听;听从
palace	n.豪华住宅;王宫
affair	n.事;事情
contact	n.接触;熟人v.使接触;接触
station	n.车站;站v.安置
beat	adj.筋疲力尽的n.跳动v.打;拍打
listen	v.听;听从
fool	n.蠢人;弄臣v.愚弄;玩弄
become	v.适合;变成
watch	n.手表;守卫v.保卫;等待
hurt	n.打击;伤v.弄痛;痛
want	n.缺乏;需要v.缺乏;要
express	adj.明确的;专门的adv.特意地;用快递n.捷运公司;快车v.表示
height	n.高;高处
size	n.尺码;大v.相比;给...上涂料
edge	n.边;刀口v.加边于;使锋利
subject	adj.臣服的;需要...的n.题目;学科v.使臣服;提供
task	n.工作;任务
follow	v.跟随;伴随
interest	n.利益;趣味v.使参与;使感兴趣
nine	n.第九;九
sympathy	n.吊慰;同情
burst	n.爆发;爆炸v.爆发;爆炸
dress	n.衣服;装饰v.布置;穿衣
lift	n.提;天空v.鼓舞;提
hope	n.希望v.希望;相信
suffer	v.经受;忍受
noise	n.声音;噪声
tell	v.吩咐;讲
mind	n.头脑;智力v.记住;照料
#farther	adv.此外;更远地far的比较级
literature	n.文献;文学
vessel	n.船;飞船;容器
affection	n.属性;影响
suffer	v.经受;忍受
proceed	v.进而做;进行
flesh	n.肥胖;肉v.长肉
advice	n.报道;劝告
grand	adj.崇高的;宏伟的n.一千英镑
carry	n.射程;运载v.提;携带
leg	n.假腿;腿
post	n.柱;岗位v.宣布;押
collection	n.募捐;收集
empty	adj.空的;空虚的n.空瓶v.使空;流出
rank	adj.极度肥沃的n.排;行列v.把...分等;级别高于
storm	n.风暴;狂风v.强击;暴怒
imagine	v.猜想;想
pocket	n.一袋;钱袋v.把...围住;皱起
arrival	n.到达;到达者
loud	adj.俗艳的;响亮的adv.大声地
sentence	n.句子;命题v.使遭受;宣判
lovely	adj.心灵美的adv.漂亮地n.美女
happen	v.发生;碰巧
absence	n.缺乏;缺席
breakfast	n.早餐v.进早餐
population	n.全部人;人口
thank	v.感谢;谢谢
rule	n.裁决;规则v.控制;统治
inhabitant	n.居民
series	n.连续;系列演出
laugh	n.笑;笑柄v.开颜;笑
address	n.地址;演说v.对付;呼吁
relief	n.缓解;救济
bird	n.鸟;幼鸟
owner	n.船长;物主
impression	n.压印;印象
coat	n.皮毛;上衣v.在...上涂
prepare	v.准备
relation	n.关系;亲属关系
shape	n.体形;形状v.形成;表规
birth	n.出生;分娩v.产生;生
rapid	adj.陡的;快的n.急流
smoke	n.抽烟;烟v.抽;熏制
January	n.一月
machine	n.机动车;机器v.使定型
content	adj.高兴的;满意的n.内容;满意v.使满意
regular	adj.定时的;恒常的n.常客;正规兵
stand	n.停住;站立v.经受;容忍
wholly	adv.全部地;完全地
busy	adj.忙的v.使忙于;忙碌
treat	n.款待;乐事v.对待;看待
burning	adj.发热的;燃烧的
shame	n.羞耻;羞辱v.感到羞耻
quality	n.品德;性质
bay	adj.枣红色的n.湾;坝v.对...吠叫;大声叫嚷
discover	v.发现;显露
inside	n.里面;内脏prep.在...的肚内;在...里面
brain	n.脑;脑袋v.重击...的头
soil	n.大地;国土v.腐蚀;弄脏
complete	adj.十足的;完成的v.使完美;完成
message	n.启示;信息v.通报
ring	n.戒指;金环v.发;鸣
call	n.号声;呼叫v.呼唤;叫
phrase	n.短语;话语v.措词;分成短句
act	n.幕;行为v.扮演;演
mention	n.传令嘉奖;提及v.传令嘉奖;提到
square	adj.成直角的;正方形的adv.成正方形;成直角n.方格;广场v.符合;结清
pair	n.一双;一条v.成对;配合
title	n.标题;一种v.给...加标题;授予...称号
understand	v.得知;理解
Sunday	n.星期天
fruit	n.果实;水果v.使结果实;结果实
mad	adj.发狂似的;疯的
force	n.力;武力v.强迫;逼叫
tea	n.茶;茶叶
rock	n.大石;矿石v.轻摇使;轻摆
slave	n.奴隶v.使从属;使做奴隶
fall	n.降落;落下v.砍倒;跌倒
absolute	adj.纯粹的;道地的n.绝对;绝对事物
slow	adj.耗时的;慢的adv.慢慢地v.放慢;放慢速度
bear	n.玩具熊;熊v.忍;压
mercy	n.慈悲;宽大处理
explain	v.讲解;解释
contain	v.包含;可包含
grief	n.悲伤;不幸
soldier	n.军事家;士兵
previous	adj.过早的;以前的
welcome	adj.被允许的;受欢迎的n.欢迎;欢迎的话v.欢迎;迎接
prayer	n.祷告;祷文
star	n.星;星宿v.用星装饰;当明星
belief	n.相信;信念
inform	v.通知;告发
moment	n.片刻;时机
poetry	n.诗;诗的特征
constant	adj.不断的;忠实的n.常数;常项
buy	n.购买v.获得;买
final	adj.决定性的;最后的n.决赛;期终考试
faithful	adj.尽职的;忠实的n.忠实信徒;虔诚徒众
ride	n.骑;骑马道v.骑;乘坐
policy	n.方针;计谋
supper	n.晚餐
draw	n.被拉的量;拉v.拔出;拉
excitement	n.刺激;激动
demand	n.需要;要求v.强要;询问
fight	n.战斗;争吵v.打;奋斗
field	n.场地;田v.接;派...上场
drove	n.人群;畜群
upper	adj.北部的;较高的n.上铺;鞋帮
sum	n.和;总数v.总结;共计
motion	n.动;提议v.摆动;做手势
assistance	n.帮助;补助
forty	n.第四十;四十
stone	n.界石;磨石v.向...扔石块;用石铺
fee	n.采邑;费
kindly	adj.仁慈的;温和的adv.仁慈地;衷心地
dignity	n.官阶;庄严
catch	n.捕获物;抓v.接住;抓住
seat	n.坐部;座v.供给...座位;使坐下
knee	n.膝部;膝关节v.向...下跪
current	adj.流动的;通行的n.电流;流
send	v.发送;派遣
object	n.对象;物体v.提出;反对
gain	n.获得;增加v.获得;增加
bitter	adj.有苦味的n.苦;苦味
possibly	adv.无论如何;也许
slave	n.奴隶v.使从属;使做奴隶
separate	adj.不同的;分开的v.分割;分隔
loose	adj.放松的;宽松的adv.宽松地v.解开;释放
text	n.课文;课本
don	n.先生v.披上
credit	n.信任;信誉v.把...归于;信任
hop	n.毒品;忽布v.飞越;跳过
print	n.印刷;印刷品v.打上;印
feature	n.脸型;面貌v.是...的特色;以...为特色
fond	adj.喜爱的
control	n.管制;指挥v.统制;抑制
capable	adj.有能力的
fifteen	n.第十五;十五
firm	adj.坚定的;坚固的n.工作小组;商号v.确认;变硬
superior	adj.较大的;较高的n.上级;占优势者
cruel	adj.残忍的;严格的
spiritual	adj.精神的n.黑人的圣歌
harry	n.袭击v.烦扰;袭击
splendid	adj.有光彩的;壮丽的
proof	n.证据;证明v.检验;校对
press	n.按;压力v.按;挤出
join	n.并;连接v.连接;参加
process	n.步骤;过程v.对...起诉;列队行进
crime	n.犯罪;罪
dust	n.地面;粉v.擦去;沾上灰
instantly	adv.立即;迫切地conj.一...
land	n.地产;陆地v.靠岸;落下
relation	n.关系;亲属关系
door	n.门;门状物
concern	n.公司;关心v.涉及;使挂念
deep	adj.深的;有...深的adv.强烈地;深深地n.海;海渊
practical	adj.可实施的;实践的
sing	v.唱;啼
destroy	v.打破;破坏
anger	n.怒;痛苦v.使发怒;发怒
result	n.获胜;结果v.发生;结果
increase	n.放大;增加v.放;增加
reason	n.理由;理智v.劝喻;讨论
nose	n.鼻子;气味v.探出;嗅
friendly	adj.朋友的;友善的adv.友好地
entrance	n.进入;入口v.使狂喜
room	n.房间;一套房间v.占一房间
admit	v.承认;接受
supply	n.供应;供应量v.供给;弥补
clean	adj.纯洁的;清洁的adv.干净地;完全地v.剥光;被打扫
useful	adj.有用的
yesterday	n.昨日;昔日
delicate	adj.柔和的;鲜美的
fail	n.不及格;交割失信v.不;缺乏
continue	v.继续;延伸
remove	v.调动;脱下
address	n.地址;演说v.对付;呼吁
choice	adj.上等的;中上级的n.选择;选择时机
huge	adj.庞大的
need	aux.须要n.缺少;需要v.缺少;需要
wear	n.穿;服装v.穿着;蓄
blind	adj.盲人的;瞎的adv.盲目地;轻率地n.眼罩;遮蔽物v.比...更亮;使瞎
unable	adj.不能的;赢弱的
cover	n.书壳;掩蔽v.盖;代替
double	adj.两倍的;双的adv.两倍地;双双地n.酷似的人;两倍v.握紧;代替
victory	n.成功;胜利
dozen	n.打;许多
constant	adj.不断的;忠实的n.常数;常项
level	adj.平的;一般高的n.基准面;水平面v.击倒;瞄准
release	n.发泄;放v.发泄;放出
rough	adj.不平滑的;未加工的n.粗人v.对...动粗;使不平
end	n.端;终止v.结束;胜过
show	n.演出;展览v.陈列;给...看
fly	n.苍蝇v.使飞;飞
praise	n.赞美;赞扬v.评价;赞颂
devil	n.恶棍;魔鬼v.给律师当助手
ahead	adv.向前;在将来
smith	n.创造者;锻工;工匠
connect	v.联系;连接
degree	n.程度;度
gain	n.获得;增加v.获得;增加
addition	n.加;增加的人
chamber	adj.室内的;私人的n.会议厅;室v.装
note	n.按语;短笺v.记录;注意
gradual	adj.不陡的;渐渐的
soul	n.精神;灵魂
mission	n.传教团;外交使团
sacrifice	n.祭品;献祭v.牺牲;献祭
mistake	n.错误;误解v.误解;误认
exercise	n.履行;运动v.履行;训练
conscience	n.良心;意识
car	n.车厢;小汽车
theory	n.理论;学说
command	n.命令;指挥v.俯临;命令
nobody	pron.没有人
minister	n.部长;公使v.敷;供给
close	adj.紧的;近的adv.接近地n.结束;终止v.关;关
energy	n.活力;能
bare	adj.赤裸的;光秃的v.揭露;使赤裸
part	n.一部分;组成部分v.放弃;分开
mistress	n.主妇
hate	n.仇恨v.不愿;仇恨
play	n.比赛;玩v.开;玩
color	n.颜色v.变色;脸红
lake	n.池;湖
safety	n.安全;无损
provision	n.供应;条文v.向...供应食品和其他必需品
asleep	adj.长眠的;麻木的
centre	n.心;正中v.集中;居中
faint	adj.微小的;无力的n.昏厥v.变得微弱;昏厥
think	v.想;想像
parent	n.父亲;祖先v.做...的父亲
careful	adj.关切的;精确的
enjoy	v.经历;享有
drop	n.滴;微量v.滴
brilliant	adj.光辉的;卓越的n.最小号铅字
brief	adj.短暂的;距离短的n.辩护状;概要v.作...的提要
bring	v.促使;出产
worship	n.崇拜;敬神v.崇拜;敬奉
goods	n.货物;衣料
tale	n.陈述;故事
skin	n.皮;外皮v.剥去...的皮;蜕皮
roof	n.顶;房屋v.给...装以特定屋面
grey	adj.灰色的n.灰色;坯布v.成为灰色
high	adj.高的;高地的adv.高;高价的n.高地;高峰
crown	n.王冠;王位v.给...戴上;露顶
castle	n.藏身所;城堡v.王车易位
throne	n.宝座;君王v.登上王位
despair	n.绝望v.对...绝望;绝望
ease	n.安适;容易v.放松;解除
attach	v.系;附属
total	adj.完全的;总的n.总数v.总数达;总计
kindness	n.仁慈
mile	n.英里
citizen	n.公民;平民
circle	n.环状物;圆v.绕过;围着
dull	adj.隐约的;愚钝的v.减轻;变钝
extreme	adj.极大的;极端的n.极度;极端
cloud	n.一大群;云v.覆盖;弄暗
figure	n.价格;数字v.计算;出现
intention	n.意思;意图
prison	n.监狱;牢狱v.监禁
term	n.词;期v.把...称为
thorough	adj.彻底的
cup	n.杯;杯子v.用杯盛;拔火罐
member	n.成员;子句
civil	adj.公民的;国内的
apply	v.涂;应用
labor	n.工作;劳动v.劳动;努力
everywhere	pron.每一处
strike	n.罢工;打v.打;敲
fair	adj.公正的adv.公正地;正面地n.美;女人
comply	v.遵从
fellow	n.男人;人
event	n.结果
gently	adv.缓慢地;平缓的
connection	n.联系;连接
protection	n.保护;保护者
conscious	n.意识;有意的
edition	n.版本
direct	adj.笔直的;直接的adv.径直地v.管理;指示
pull	n.拉;拉力v.采;拉
flight	n.飞翔;抽逃
evident	adj.明显的
surround	v.包围;围住
yard	n.码;庭院;场地
voice	n.禽鸣声;说话声v.给...整音;说
weary	adj.疲劳的;厌倦的v.渴望;疲劳
couple	adj.两个n.夫妻;一对v.联想;连接
variety	n.变化;种类
whilst	conj.直到
volume	n.音量;卷;体积
detail	n.细部;细节v.列举;详述
custom	n.光顾;习惯
apart	adv.成距离;成零碎
bow	n.弓;虹v.弯曲;鞠躬
awful	adj.使人畏惧的adv.十分
everybody	pron.每人
ask	v.问
lover	n.爱人;情夫
show	n.演出;展览v.陈列;给...看
suit	n.套;衣服v.适合;合适
plan	n.方法;计划v.计划;设计
render	v.付给;给予
picture	n.画v.绘;映出
lest	conj.唯恐
volunteer	adj.志愿的;自生的n.志愿兵;自愿者v.自愿;自愿提供
sing	v.唱;啼
eager	adj.敏锐的;热切的
precious	adj.贵重的adv.极其n.珍爱的人
require	v.想要;需要
meat	n.肉;食物
whenever	adv.无论什么时候conj.无论什么时候
milk	n.奶;乳剂v.抽取;出奶
dog	n.公狗;狗v.跟踪;困扰
successful	adj.成功的;有成就的
plant	n.秧苗;植物v.插;种
vision	n.幻觉;看;视觉
rare	adj.稀薄的;稀有的adv.很v.渴望
grant	n.给予;授予物v.承认;授予
raise	n.高岗;提高v.举起;竖起
manner	n.方式;态度
cousin	n.堂兄弟;远亲
cool	adj.冷静的;凉的n.冷淡;冷静v.变凉;减缓
trial	adj.审讯的;试验的n.麻烦;试
learn	v.发现;学
approach	n.进路;近似v.近似;靠近
bridge	n.鼻梁;桥v.架桥于;跨越
abroad	adv.到国外;出国
pay	n.报偿;付钱v.付;付款
literary	adj.书面的;文学的
writer	n.执笔者;作者
disappear	v.使不见;消失
interrupt	n.隔阂;中断v.打断;中止
stock	n.砧木;主干;储备v.备货;发肿
reader	n.读者;教科书
dreadful	adj.可怕的;糟透了的n.廉价刺激性小说
female	adj.雌的;女的n.雌性动物;女子
protect	v.保护
accustom	v.使习惯于
type	n.类型v.翻印;打字
salt	n.盐;盐状物v.撒盐于...上;以盐喂
destroy	v.打破;破坏
sign	n.标志;符号v.签;写下
innocent	adj.率真的;清白的n.无罪的人;新手
temper	n.性情;脾气v.回火;缓和
plenty	adj.很多的adv.充分地n.丰富;富裕
avoid	v.避开;避免
represent	v.代表;使有代表
favor	n.得宠;恩惠v.赐与;喜爱
mental	adj.精神的;颏的
attitude	n.态度;姿势
return	n.回;送回v.回报;回
admiration	n.惊奇;钦佩
brother	n.兄弟;挚友
anxiety	n.焦虑;渴望
queen	n.酋长夫人;王后
teach	v.教;教导
count	n.计算;数数v.数;值
curiosity	n.好奇;奇物
solemn	adj.隆重的;严肃的
cause	n.理由;事业v.使;使产生
vessel	n.船;飞船;容器
dance	n.跳舞;舞v.舞;舞动
hotel	n.饭店;公馆
wicked	adj.坏的;淘气的
kiss	n.轻拂;吻v.轻拂;吻
gun	n.鸣放;炮v.向...开枪;加大油门
fill	n.充分;装填物v.挤满;装满
visible	adj.明显的;现有的
guide	n.导游;向导v.操纵;给...领路
earnest	adj.认真的;重要的n.保证;定金
actual	adj.实际的;现行的
companion	n.同伴;职业伴侣
prisoner	n.犯人;刑事被告
miserable	adj.贫困的;痛苦的n.遭受苦难的人
lad	n.家伙;男孩
harm	n.损害;邪恶v.损害
view	n.观看;视力v.查看;观看
utter	adj.绝对的;完全的v.发出;发射
end	n.端;终止v.结束;胜过
shop	n.购物;商店;营业v.选购;浏览
stair	n.楼梯;梯级
pardon	n.饶恕;赦免v.免除;赦免
gay	adj.欢快的adv.很;卖弄地
beg	v.恳求;请
seldom	adv.不常
kind	adj.和蔼的;友好的n.类;种类
record	n.记录;履历v.登记;记录
fat	adj.肥胖的;育肥的n.肥肉;脂肪
sand	n.沙;沙滩v.撒沙于;沙淤
violent	adj.暴力的;狂热的
flat	adj.瘪的;平的adv.平直地;完全地n.平面;一层
departure	n.背离;开始
deliver	v.交出;投递
gift	n.礼物;赠送
ruin	n.毁灭;破产v.毁坏;毁灭
skill	n.技术;熟练性
cattle	n.大众;牛
equipment	n.才能;配备
temple	n.教堂;圣堂
call	n.号声;呼叫v.呼唤;叫
license	v.批准;准许
visit	n.参观;视察v.访问;视察
consent	n.融洽;同意v.同意;一致
sufficient	adj.自负的;足够的
native	adj.出生的n.当地人;土人
laughter	n.笑;笑意
contain	v.包含;可包含
scattered	adj.分散的;散射的
whence	adv.从何处;从那里conj.据此
rush	n.冲;匆忙v.猛推;冲
chief	adj.为首的;主要的n.酋长;首领
bold	adj.冒失的;勇敢的n.黑体
anywhere	pron.任何地方
witness	n.证据;证人v.目击;作证
foolish	adj.发窘的;荒谬的
help	n.帮助;补救办法v.帮助;助
kitchen	n.厨房;厨师
sell	n.欺骗;推销v.出卖;卖
anybody	pron.任何人
self	n.本性;私利
extreme	adj.极大的;极端的n.极度;极端
treatment	n.处理;对待
throat	n.嗓音;咽
dream	n.出神;梦v.做;想
patient	adj.忍耐的;有耐心的n.病人;顾客
speed	n.快;速率v.促进;快走
growth	n.生长;增长
quantity	n.大量;量
immense	adj.广大的;无限的
conclusion	n.结论;结尾
computer	n.计算机;计算器
affect	n.内心倾向;自觉感情v.打动;侵袭
severe	adj.尖锐的;严肃的
excuse	n.藉口;歉意v.为...辩解;原谅
triumph	n.胜利;喜悦v.征服;获胜
origin	n.出身;起端
eternal	adj.永恒的;永久的n.上帝
audience	n.读者;观众
page	n.记录;页v.翻阅;侍侯
sound	adj.健康的;牢固的n.声;音v.宣告;发音
swift	adj.迅速的n.褐雨燕
limit	n.范围;限度v.限定;限制
wing	n.翅;翅膀v.飞过;飞
service	n.服务v.检修;为...服务
library	n.书房;图书馆
remain	v.留下;剩余
contain	v.包含;可包含
base	adj.基础的;卑劣的n.基;基础v.驻扎;作...的基础
confusion	n.困惑;骚乱
win	n.胜利;赢得物v.赢得;成功
maid	n.处女;少女
charm	n.美貌;魅力v.使高兴;行魔法
edition	n.版本
attend	v.出席;侍候
soft	adj.轻的;柔滑的adv.柔软地;嘘
reality	n.实在;现实
perform	v.履行;做
glorious	adj.光荣的;壮丽的
likewise	adv.同样地;也
site	n.地方;地皮v.给...择址;设置
sail	n.帆;帆船v.驾驶;漂浮
frighten	v.使惊恐
acquaint	v.使认识
unhappy	adj.不恰当的;不幸的
fear	n.害怕;可能性v.害怕;恐怕
article	n.契约;条款;物品;冠词v.列举;进行控告
prisoner	n.犯人;刑事被告
store	n.储存;大量v.储备;装满
adopt	v.采取;继承
remark	n.言辞;注意v.说;注意
cook	n.厨子;蒸煮v.烹调;烧
thousand	n.第一千;一千
pause	n.停顿;暂停v.踌躇;暂停
band	n.群;箍v.聚集
valuable	adj.贵重的;有价值的n.贵重物品
hence	adv.去;因此
desert	n.荒漠;沙漠v.背离;抛弃
effect	n.感受;结果v.产生;使发生
kiss	n.轻拂;吻v.轻拂;吻
plant	n.秧苗;植物v.插;种
ice	n.冰;冰状物v.使凉;结冰
ball	n.球;舞会v.交媾;狂欢
stick	n.棍;木条v.刺;停留
absolute	adj.纯粹的;道地的n.绝对;绝对事物
readily	adv.乐意地;迅速地
behold	v.看;注视
fierce	adj.狂热的;猛烈的
argument	n.理由;说理
observe	v.观察;说
bless	v.使神圣;为...祝福
bosom	adj.胸的;知心的n.乳房;胸v.抱
rage	n.狂暴;狂怒v.发怒;狂吹
discovery	n.发现;泄露
creature	n.人;生物
shout	n.呼喊v.呼喊;叫嚷
guilty	adj.有过失的;有罪的
punishment	n.罚
gun	n.鸣放;炮v.向...开枪;加大油门
slight	adj.少量的;纤细的n.冷落;轻视v.忽视;看轻
article	n.契约;条款;物品;冠词v.列举;进行控告
police	n.警察;警察部门v.管理
mysterious	adj.神秘的
extend	v.扩展;伸
confess	v.坦白;忏悔
shade	n.荫;阴暗v.隐瞒;遮
murder	n.谋杀;破坏v.扼杀;谋杀
emotion	n.动;情感
wonder	n.惊奇;奇迹v.感到惊讶;感到疑惑
hide	n.皮肤;生命v.隐瞒;遮掩
expedition	n.出征;旅行
horror	n.恐怖;恐怖性
local	adj.局部的;位置的n.当地居民;市郊列车
expense	n.花钱;价钱
ignorant	adj.不知道的;无知的
doctrine	n.教诲;教义
generous	adj.大的;慷慨的
range	n.级别;排;山脉v.排列;变动
host	n.主人;军队v.招待;群集
wet	adj.多雨的;湿的n.湿气;雨v.尿湿;变湿
cloud	n.一大群;云v.覆盖;弄暗
mystery	n.奥秘;神秘
waste	n.废料;浪费v.浪费;消耗
change	n.改变;更动v.改变;换去
possess	v.具有;拥有
disease	n.病;病害
former	adj.前任的;以前的
spend	v.花;用
production	n.产品;产生
source	n.出处;源
mankind	n.男子;人类
universal	adj.全体的;宇宙的n.共相;谓项
deck	n.甲板;桥面v.击倒;装饰
see	v.察看;看
habit	n.气质;习惯
estate	n.地产
aunt	n.阿姨;伯母
reign	n.统治;主宰v.盛行;为王
humble	adj.谦逊的v.使谦逊
compliance	n.柔量;顺从
delay	n.延迟v.耽搁
shin	n.胫;胫骨v.攀;快步走
report	n.报道;报告v.报道;说
hers	pron.她的
midnight	n.半夜十二点钟;漆黑
listen	v.听;听从
flower	n.花;精华v.发育;开花
hero	n.男主角;英雄
accomplish	v.达到;实现
thank	v.感谢;谢谢
bank	n.岸;堆v.开银行;做庄家
philosophy	n.哲理;哲学
belong	v.合适;属
finger	n.手指;指状物v.指出;伸出
market	n.集市;市场v.销售;进行交易
cap	n.便帽;根冠v.覆盖;给...带帽
wave	n.波;高潮;挥手;浪v.招手;波动;飘摇
pick	n.掏;凿v.掏;凿
purpose	n.目的;效用
somewhere	pron.某处
delight	n.高兴;可爱性v.使高兴;感到高兴
push	n.突出;推v.推;突出
press	n.按;压力v.按;挤出
household	n.王室;一家人
fleet	adj.短暂的;浅的n.船队;海军
baby	n.婴儿;幼畜v.轻击
region	n.地区;各地区
lately	adv.近来
utter	adj.绝对的;完全的v.发出;发射
exact	adj.精密的;精确的v.索取;要求
image	n.外形;像v.想象;造像
age	n.成年;年龄v.使老;变陈
murmur	n.细声;小声话语v.小声抱怨;小声说
melancholy	adj.忧郁的n.忧思;忧郁
suspicion	n.怀疑;一点儿v.怀疑
bow	n.弓;虹v.弯曲;鞠躬
refuse	n.废料v.拒不;拒绝
staff	n.工作班子;全体职员v.雇用
liability	n.倾向;责任
enjoy	v.经历;享有
stretch	n.舒展;延伸v.拉直;舒展
gaze	n.凝视v.盯着看
belong	v.合适;属
ashamed	adj.惭愧的
reward	n.报答;酬金v.报答;酬谢
meal	n.挤奶;进餐
blame	n.责任;指责v.指责;诅咒
status	n.地位;法律地位
opinion	n.评价;意见
indicate	v.标示;表明
poem	n.诗
savage	adj.不文明的;凶恶的n.粗鲁的人;野蛮人v.激怒;乱咬
arise	v.起立;上升;出现;发生
voyage	n.航程;航海v.航行越过;航海
misery	n.疼痛;痛苦
guest	n.客;旅客
paint	n.涂漆;颜料v.画;描写
attend	v.出席;侍候
afford	v.买得起;提供
donate	v.放出;捐
job	n.工作;职业
proceed	v.进而做;进行
love	n.爱;爱情v.爱;恋爱
regret	n.懊悔;道歉v.痛惜;因...懊悔
plain	adj.单色的;朴素的n.平原;平针
risk	n.危险;危险率v.把...作赌注;冒...的危险
ad	n.作广告
light	adj.淡色的;轻的adv.轻装地n.光;光感v.点;照亮
angel	n.安琪儿;天使
rapid	adj.陡的;快的n.急流
distinct	adj.明显的;有区别的
doubtless	adj.无疑的adv.公认地;无疑地
proper	adj.本来的;适宜的
wit	n.风趣;智力v.知道
fame	n.传闻;名声
singular	adj.独一的;非凡的
error	n.错误;谬见
utmost	adj.极度的;最远的n.极限
method	n.方法;条理
reputation	n.好名声;名气
appeal	n.呼吁;上诉v.控告;呼吁
strong	adj.极大的;强壮的adv.强烈地;强有力地
lack	n.缺乏;需要v.短少;缺乏
break	n.破裂;破晓v.打破;破坏
dawn	n.开端;黎明v.开始;破晓
violence	n.暴力;猛劲
fatal	adj.致命的;重大的
render	v.付给;给予
career	n.成功;全速;职业;专业v.使奔驰;奔驰adj.职业的
design	n.设计;图案v.决意;谋划
display	n.展览;展示v.陈列;炫耀
get	v.获得;取得
commercial	adj.商品的;商业的n.商业广告;宣传
forgive	v.豁免;容许
light	adj.淡色的;轻的adv.轻装地n.光;光感v.点;照亮
agreeable	adj.适合的;同意的
suggestion	n.暗示;建议
utter	adj.绝对的;完全的v.发出;发射
sheep	n.羊;羊皮革
resolution	n.决心;判决
spare	adj.备用的;剩下的n.备件;姘妇v.节约;宽容
patience	n.坚忍;忍耐
domestic	adj.非野生的;家的n.国货;家仆
farm	n.农场;饲养场v.耕作;种植
reference	n.参照;引文出处v.提出...作参考
exist	v.存在;发生
corn	n.谷粒;鸡眼
approach	n.进路;近似v.近似;靠近
alike	adj.同样的adv.一样地
mount	n.登;山v.登上;登
issue	n.河口;结果v.发行;分配
key	n.答案;方法v.为...调音;钉防
majority	n.多数;多数党
measure	n.尺寸;量度v.打量;量
town	n.城市;镇
flame	n.光辉;火焰v.变热;发光
ignorance	n.不知;无知
occasional	adj.临时的;偶尔的
weakness	n.爱好;弱点;软弱
furnish	v.供应;装设备于
priest	n.祭司;司铎
flying	adj.飞的;飞似的
cloth	n.布;桌布
profit	n.利;利益v.得益;获利
bell	n.钟;钟声v.鸣钟;吼叫
hitherto	adv.到这儿;迄今
benefit	n.义演;益处v.有益于;得益
movement	n.动;动作
eager	adj.敏锐的;热切的
act	n.幕;行为v.扮演;演
atmosphere	n.大气;空气;大气层
chapter	n.章;重要章节
hole	n.巢穴;洞v.打;打洞
depart	v.离开;死
catholic	adj.罗马天主教的n.罗马天主教徒adj.广泛的;宽容的n.扒手
file	n.文件夹;锉刀v.发送;锉
reasonable	adj.公平的;正当的
sugar	n.食糖;糖
sigh	n.叹气v.悲叹;渴望
humanity	n.人道;人类
thrust	n.猛推;要点v.插;刺
frame	n.车架;构架v.构筑;制订
opposition	n.敌对;反对
disk	n.花盘;盘
haste	n.草率;急迫
lonely	adj.孤独的;寂寞的
artist	n.能手;艺术家
knight	n.爵士;骑士v.授...以爵士品位
quarter	n.四分之一;一刻钟
charm	n.美貌;魅力v.使高兴;行魔法
substance	n.实质;物质
roll	n.小圆面包;一卷v.卷;推
division	n.分;分配
slavery	n.奴隶身份;奴隶制
verse	n.韵文;诗;节v.使熟练
decision	n.决定;决议
probable	adj.有充分根据的
painful	adj.困难的;疼痛的
governor	n.长官;州长
forever	adv.老是;永远
turn	n.翻动;旋动v.翻动;旋动
branch	n.分部;树枝v.出枝;分支
ocean	n.海洋;海
rear	adj.后部的;后方的n.后部;后方v.抚养;竖起
leader	n.领先者;领袖
star	n.星;星宿v.用星装饰;当明星
boat	n.船v.用船装运;乘船
keen	adj.刺人的;锋利的
sense	n.感官;感觉v.检测;了解
occasion	n.时机;时刻v.引起
readable	adj.易辨认的;易读的
beloved	adj.受爱戴的;所钟爱的n.心爱的人
bone	n.骨;骨质v.施骨肥于;苦学
enthusiasm	n.热心;宗教狂热
material	adj.身体上的;物质的n.布;材料
luck	n.好运;运气v.凑巧碰上;逢凶化吉
community	n.社会;团体
apparent	adj.表面上的;显然的
hurry	n.急忙;渴望v.急派;赶紧
scheme	n.计划;系统v.计划;密谋
oil	n.石油;油v.溜;融化
thence	adv.所以;之后
reach	n.地带;伸出v.到达;伸出
dim	adj.暗淡的;差的n.昏暗;减光v.使暗淡;使减光
wretched	adj.不幸的;极坏的
hang	v.吊死;悬挂
pipe	n.管子;烟斗v.吹奏;发尖声
useless	adj.差劲的;无益的
print	n.印刷;印刷品v.打上;印
smooth	adj.光溜的;磨平的v.弄平;铺平
solid	adj.固体的;牢固的adv.肯定;全部地n.固体;固形物
build	n.体形;构造v.构成;建设
attempt	n.攻击;企图v.企图;引诱
egg	n.蛋;人v.向...扔蛋;鼓励
equivalent	adj.等价的;同解的n.当量;相等物
burn	n.燃烧;烧伤v.点燃;烧掉
recent	adj.全新世的;最近的
travel	n.旅行;漫游v.经过;旅行
noon	n.午夜;正午
cry	n.叫喊;哭v.哭;鸣
generation	n.产生;代
cabin	n.房舱;棚屋
hand	n.脚;手v.搀扶;交
cease	n.停止v.停止;停
tent	n.帐篷;帷幕v.观察;注意
frequent	adj.经常的v.常到;交往
alarm	n.惊恐;警报v.打扰;使惊恐
nervous	adj.神经的;神经质的
beast	n.动物;畜生
#aloud	adv.出声地;大声的the	det.定冠词;表示特指
of	prep....的;含有...的
and	conj.和
to	prep.到;离
in	prep.在...里面;在...期间
that	det.那个
his	pron.他的;它的
he	pron.他;一个人
it	pron.它
with	prep.加在...上;在...一边
for	prep.为;为了
as	prep.当作;像conj.当...时;像...
you	pron.你;你这个
not	adv.并非;不
be	v.表示;是
her	pron.她
on	prep.靠近...;在...里
at	prep.向;在...里
by	prep.偏于;在...旁边
which	pron.那个;那些
have	v.拿取;有
or	conj.或者
from	prep.从;从...来
this	pron.后者;这
him	pron.他
but	conj.但是
all	adv.单单;更其pron.全体;一切
she	pron.它;她
they	pron.人们;他们
my	det.我的
me	pron.我
one	n.一;一体
their	det.他们的
so	adv.啊;同样conj.为了;因此
an	det.一
them	pron.那些;他们
we	pron.我们;人们
who	pron.谁;他
will	aux.将;能n.决心;意愿
no	adv.不;毫不n.不;反对票
when	adv.其时;什么时候conj.其时;一...就
there	pron.那里
if	conj.假如;使
more	adj.更大的;另外的adv.更;再
out	adv.出;呸prep.从...里面;从...中出来
up	prep.往...的上端;往...的上游
into	prep.朝;进
do	v.做
any	adv.多少;略pron.若干
your	det.你的
what	pron.什么;无论什么
man	n.男子;人
other	adj.别的;不同的n.对立的事物
than	conj.比;除...
our	det.我们的
some	pron.很多;一些
very	adv.非常
time	n.时间;时刻v.调准;为...定时
upon	prep.覆盖;接触
about	adj.活动中的prep.在...附近;在...前后
may	aux.会;可能n.五月
its	det.它的
only	adj.独生的;唯一的adv.不料;只
now	pron.现在
like	adj.相同的;相像的prep.比如;像conj.好像;如同v.喜欢;要
little	adj.小的;幼小的adv.毫不;难得
then	pron.那时
can	aux.可以;能n.大酒杯;容器v.把...装罐保存
us	n.美国pron.人们;我们
such	adj.那么的;这种的
a	det.一
great	adj.大的;久的n.大人物
before	adv.较早;以前prep.在...前面;在...以前conj.不愿...;在...以前
must	aux.必须;务必
two	n.第二;二
these	det.这些
see	v.察看;看
know	v.记住;确知
over	adv.报文完;下prep.高于;在...的上方
much	adv.常常;十分
down	prep.往...的下端;沿
after	prep.随...之后;在...后面conj.在...以后
first	adj.第一的;基本的adv.宁可;先
good	adj.好的;正当的
own	adj.自己的n.属于自己的东西v.承认;有
never	adv.不;从不
most	adv.极其;最
old	adj....岁的;老的
shall	aux.将要;一定
day	n.天;昼
where	adv.在哪里;在那里conj.然而;在...处
those	det.那些
come	v.搞;来
himself	pron.他亲自;他自己
way	n.方法;方面
work	n.工作;职业v.经营;工作
life	n.生命;一生
without	adv.外表上;在外面prep.不;无
go	v.对付;忍受
make	n.牌子;体质v.构成;做
well	adj.对的;井的adv.好;很n.好;井v.涌出;流出
through	prep.遍及;从...头至尾
be	v.表示;是
long	adj.长的;长时间的adv.长久;始终v.渴望;归属
say	adv.哎呀;大约n.决定权;细哔叽v.讲述;说
might	n.大量;力量
how	adv.多少;怎样
#am	v.be的第一人称现在时形式
too	adv.很;太
even	adj.均匀的;平的adv.甚至;完全v.使平衡;使平坦
again	adv.到原处;又
many	adj.许多的pron.许多人
back	adj.背后的;边远的adv.往回;向后n.背;缸v.使后退;后退
here	pron.这里
think	v.想;想像
every	det.每一个
people	n.人;人民v.居住于;使充满
same	adj.同样的;同一的
last	adj.最低的;最后的adv.上一次;最后v.度过;楦
away	adv.走吧;走开
under	prep.在...之下
take	n.捕猎;拿v.拿;执住
hand	n.脚;手v.搀扶;交
eye	n.目光;视力v.看;考虑
still	adj.静止的;平静的adv.还是;还要v.静止;渗出
place	n.场所;地方v.放置;得名次
while	conj.虽然;直到v.消磨
just	adj.应得的;正义的adv.刚才;只是
also	adv.也;而且;同样地
young	adj.年轻人的;幼小的
yet	adv.还;迄今;尽管
though	adv.可是;尽管conj.可是;即使
against	prep.对...不利;逆
thing	n.事;物
get	v.获得;取得
ever	adv.总是
give	v.给予;交给
god	n.上帝n.男神;神
year	n.年;年度
off	prep.离...;偏离...
face	n.表面;脸v.面朝;朝
nothing	pron.没有东西
right	adj.合适的;正当的adv.好;正当地n.实况;正当v.补救;纠正
once	adv.一次;一旦conj.一旦...
another	pron.又一个
part	n.一部分;组成部分v.放弃;分开
saw	n.锯;锯床v.锯;锯成
house	n.房屋;棚v.覆盖;住
world	n.世界
head	n.上端;头v.长头;发源
three	n.第三;三
new	adj.新的;新鲜的
love	n.爱;爱情v.爱;恋爱
always	adv.永远;总是
put	v.放;出发
night	n.黑夜;夜
each	adv.对各个pron.各个
king	n.大王;君主
between	adv.在中间prep.联接着...;在...之间
tell	v.吩咐;讲
mind	n.头脑;智力v.记住;照料
heart	n.内心;心
few	adj.很少的;有些pron.很少数;少数
because	conj.因为
thing	n.事;物
whom	pron.谁;他
far	adj.较远的;远的adv.远
seem	v.感到好像;好像发生
look	n.察看;看v.看
call	n.号声;呼叫v.呼唤;叫
whole	adj.全部的;整个的n.全部;统一体
set	n.集子;一套v.放;落
both	adv.在两方面同样地pron.两者
find	n.发现;发现物v.发现;找出
look	n.察看;看v.看
name	n.名字;外号v.把...叫作;给...取名字
day	n.天;昼
let	n.出租;租户v.使;允许
lord	n.主;君主;领主v.称...为勋爵;指挥
country	n.地区;国
ask	v.问
going	adj.成功的;去的n.地面状况;去
#better	adv.多;更好地v.超过;改善good的比较级
home	adv.在家;在家乡n.家;家庭v.回家;有家
side	n.边;旁边v.同意;赞助
something	pron.某;某物
moment	n.片刻;时机
father	n.父;父亲v.生
among	prep.被...所环绕;系...中之一
course	n.进行;行动方向v.追;跑
hands	n.拥有;控制
woman	n.成年女子;女人
enough	adj.足够的adv.够了;很
word	n.词;话v.通知;讲话
mother	n.继母;母v.生;产生醋母
soon	adv.不久;早
full	adj.彻底的;满的
end	n.端;终止v.结束;胜过
room	n.房间;一套房间v.占一房间
almost	adv.几乎
small	adj.细小的;小的n.狭窄部分;小件物品
water	n.矿泉水;水v.喷淋;饮水
want	n.缺乏;需要v.缺乏;要
however	adv.不管怎样;究竟怎样
light	adj.淡色的;轻的adv.轻装地n.光;光感v.点;照亮
quite	adv.很;完全
nor	adv.也不
word	n.词;话v.通知;讲话
whose	det.谁的
door	n.门;门状物
turn	n.翻动;旋动v.翻动;旋动
doe	n.雌鹿
use	n.用;用途v.发挥;用
morning	n.初期;破晓
myself	pron.我亲自;我自己
until	prep.向;在...之前conj.在...以前;直到...时
since	adv.从那以后;之前prep.自...以来conj.因为;自...以来
power	n.力;能力v.促进
themselves	pron.他们亲自;他们自己
us	n.美国pron.人们;我们
rather	adv.宁可;有几分
present	adj.出席的;现在的n.现在;礼物v.表示;提出
voice	n.禽鸣声;说话声v.给...整音;说
other	adj.别的;不同的n.对立的事物
white	adj.白色的;无血色的n.白色;纯洁
work	n.工作;职业v.经营;工作
less	adj.较小的adv.较小地
money	n.财产;货币
next	adj.紧邻的;居后的adv.接下去;下次
poor	adj.贫乏的;贫穷的
death	n.灭亡;死
form	n.模型;形体v.构成;形成
within	adv.户内;内心prep.在...里面;在...之内
together	adv.到一起;同时
till	prep.及于;在...以前conj.在...以前;直到...为止
large	adj.大的;开阔的
matter	n.实体;事情v.化脓;要紧
kind	adj.和蔼的;友好的n.类;种类
often	adv.常常;通常
certain	adj.固定的;可靠的
herself	pron.她亲自;她自己
year	n.年;年度
friend	n.朋友;赞助者
half	n.半;半场
order	n.次序;整齐v.命令;整理
round	adj.丰满的;圆的n.圆圈;圆形物prep.围绕;向...各处v.变圆;环行
true	adj.纯正的;真的adv.纯种地;真实地v.装准
anything	pron.任何事物
keep	n.保持;供养v.保管;保守
wife	n.妇人;妻子
mean	adj.卑鄙的;低劣的n.平均;中间v.意味着;意指
believe	v.认为;想
pass	n.境况;通过v.超过;经过
near	adj.近的;近似的adv.近;近似地prep.靠近v.靠近
public	adj.公开的;公众的n.公众;一群人
state	n.心情;形态v.陈述;确定
son	n.儿子;女婿
hundred	n.第一百;一百
thus	adv.如此;因此;迄今为止
hope	n.希望v.希望;相信
alone	adj.单单;单独的adv.单独地;仅仅
above	adj.上面出现过的adv.在顶部;在上面prep.多于;高于
case	n.框;箱v.探察
dear	adj.可爱的;亲爱的adv.非常;呵n.可爱人;亲爱的
say	adv.哎呀;大约n.决定权;细哔叽v.讲述;说
person	n.家伙;人
high	adj.高的;高地的adv.高;高价的n.高地;高峰
city	n.城市;全市居民
already	adv.马上;已经
received	adj.被普遍接受的
fact	n.事实;细节
girl	n.女孩子;女仆
hear	v.听;听见
time	n.时间;时刻v.调准;为...定时
least	adj.最少的adv.最少n.最少量
perhaps	adv.或许
sure	adj.可靠的;确信的adv.当然;无疑
indeed	adv.哦;确实
open	adj.开着的;空旷的n.旷野;露天v.开;开辟
body	n.躯干;肉体
itself	adv.究竟pron.它自己;自身
along	prep.沿着;依照
land	n.地产;陆地v.靠岸;落下
return	n.回;送回v.回报;回
leave	n.告别;许可v.丢弃;经过
air	n.空气;天气v.晾;晾
nature	n.大自然;禀性
answer	n.答案;反应v.回应;回击
either	adv.也pron.任何一个
law	n.法律;法制
help	n.帮助;补救办法v.帮助;助
lay	adj.世俗的;外行的n.层;歌曲v.置放;产卵
point	n.尖;尖形部件v.显示;指
child	n.小孩;婴儿
letter	n.信;字母v.在...上刻字
four	n.四;匍匐
wish	n.请求;希望v.但愿;祝
fire	n.电炉;火v.烧制;发热
speak	v.讲;说
number	n.数目;算术v.把...编号;计数
therefore	adv.因此
hour	n.时间;小时
friend	n.朋友;赞助者
free	adj.自由的adv.免费地;松开着v.使摆脱;使自由
war	n.斗争;战斗v.击败;斗争
during	prep.在...期间的某一时候
several	pron.几个
business	n.交易;职业
whether	conj.是...;是否
manner	n.方式;态度
second	adj.次要的;第二的adv.第二;以第二位n.秒;片刻v.赞成;支持
reason	n.理由;理智v.劝喻;讨论
unit	n.单位;股份单位
call	n.号声;呼叫v.呼唤;叫
general	adj.笼统的;全体的n.将军;上将
why	adv.为什么
behind	adv.在背后;在过去n.后卫;屁股prep.落后于;在...后面
john	n.厕所;男人
become	v.适合;变成
dead	adj.不动的;死亡的adv.全然地;直接地
earth	n.尘世;地球v.把...接地;用土掩盖
boy	n.男孩;男子
forth	adv.往外;向前
thousand	n.第一千;一千
look	n.察看;看v.看
family	n.户;家
soul	n.精神;灵魂
feel	n.触;触觉v.触;发觉
England	n.英格兰
spirit	n.精神;灵魂v.鼓励;偷偷地走
question	n.难题;问题v.怀疑;问
care	n.小心;忧虑v.喜欢;关心
truth	n.实情;事实
really	adv.很;说真的
rest	n.长眠;平静v.长眠;休息
mean	adj.卑鄙的;低劣的n.平均;中间v.意味着;意指
different	adj.差异的;各别的
possible	adj.可能的
fell	adj.残暴的;剧痛的n.折缝;山v.缝;击倒
towards	prep.对;向
human	adj.人的;似人类的n.人
short	adj.矮的;短的adv.唐突地;突然地n.短路;要点v.卖空;短路
town	n.城市;镇
follow	v.跟随;伴随
need	aux.须要n.缺少;需要v.缺少;需要
cause	n.理由;事业v.使;使产生
evening	n.傍晚;后期
return	n.回;送回v.回报;回
five	n.五
strong	adj.极大的;强壮的adv.强烈地;强有力地
able	adj.得以...的
live	adj.活的;真的adv.在现场v.过;活
lady	n.贵妇人;女士
subject	adj.臣服的;需要...的n.题目;学科v.使臣服;提供
answer	n.答案;反应v.回应;回击
sea	n.海;内海
fear	n.害怕;可能性v.害怕;恐怕
understand	v.得知;理解
hard	adj.坚硬的;紧的adv.坚硬地;困难地
terms	n.条件;细则v.接受;妥协
doubt	n.迟疑;怀疑v.怀疑;迟疑
around	adv.兜着圈子;在周围prep.环绕;在...各处
ask	v.问
arm	n.臂;军种v.提供;武装起来
turn	n.翻动;旋动v.翻动;旋动
sense	n.感官;感觉v.检测;了解
seem	v.感到好像;好像发生
black	adj.黑暗的;黑色的n.黑色v.变黑
bring	v.促使;出产
follow	v.跟随;伴随
beautiful	adj.出色的;美的
close	adj.紧的;近的adv.接近地n.结束;终止v.关;关
dark	adj.黑暗的;深黑n.黑色;黑暗
hold	n.拿;船舱v.表现;掌着
character	n.品德;性质
sort	n.性质;种类v.拣出;符合
sight	n.检查;看见;视觉v.观测;看到
ten	n.第十;十
show	n.演出;展览v.陈列;给...看
party	adj.共有的;政党的n.党;队;聚会
fine	adj.快的;美好的adv.很;细小地n.罚金;租费v.使纯;变纯
ready	adj.快要...的v.使准备好;准备好
story	n.情节;小说
common	adj.公共的;普通的n.共用牧地
book	n.卷;书v.预订;预订
electronic	adj.电子的
talk	n.讲话;闲话v.讲;谈论
account	n.记述;解释v.报帐;导致
mark	n.马可福音;马可n.短线;符号v.标明;评分
interest	n.利益;趣味v.使参与;使感兴趣
bed	n.床;卧室v.睡;性交
necessary	adj.必然的;必要的
age	n.成年;年龄v.使老;变陈
else	adv.否则;其他
force	n.力;武力v.强迫;逼叫
idea	n.计划;思想
longer	adj.较长
art	n.美术;艺术
spoke	n.辐条
across	prep.穿过...;与...相交叉
brother	n.兄弟;挚友
early	adj.早的;早期的adv.从前;早
ought	v.欠;占有
sometimes	adv.以前;有时
line	n.纹路;线v.出局;填
say	adv.哎呀;大约n.决定权;细哔叽v.讲述;说
table	n.一桌酒菜;桌子v.把...列表
appear	v.出现;露面
river	n.河;巨流
eye	n.目光;视力v.看;考虑
sun	n.恒星;日光v.晒;晒太阳
#later	adv.后来;再见late的比较级
everything	pron.每件事;一切
reach	n.地带;伸出v.到达;伸出
sudden	adj.突然的;迅速的
hour	n.时间;小时
strange	adj.陌生的;外地的
deep	adj.深的;有...深的adv.强烈地;深深地n.海;海渊
change	n.改变;更动v.改变;换去
mile	n.英里
feel	n.触;触觉v.触;发觉
act	n.幕;行为v.扮演;演
meet	n.集合;集会v.接;遇见
#further	adv.此外;更远地v.促进far的比较级
purpose	n.目的;效用
happy	adj.乐意的;愉快的
add	v.添加;做加法
seem	v.感到好像;好像发生
blood	n.血;血统
rose	n.玫瑰;玫瑰色;玫瑰香水
south	adj.南部的;在南方的adv.向南方n.南;南部
beyond	prep.迟于;深于
cold	adj.感觉冷的;冷的adv.突然地;完全地n.感冒;冷
neither	adv.也;也不pron.无一个
forward	adj.热心的;早的adv.提前地;向前n.前锋v.促进;发送
view	n.观看;视力v.查看;观看
position	n.恰当位置;位置v.安放;驻扎
sound	adj.健康的;牢固的n.声;音v.宣告;发音
none	pron.没有一个;没有一人
enter	v.参加;登记
clear	adj.纯色的;清晰的adv.离开着;完全v.扫清;变晴
road	n.街道;路
late	adj.迟的;晚的adv.迟;晚
stand	n.停住;站立v.经受;容忍
suppose	v.猜想;假定
daughter	n.女儿;女性后裔
real	adj.逼真的;真的
nearly	adv.极;几乎
mine	n.矿;矿藏pron.我的v.采;开矿
law	n.法律;法制
knowledge	n.熟悉;知识
come	v.搞;来
bad	adj.坏的;顽皮的
cut	n.切;切口v.切;凿
copy	n.本;原件v.抄袭;抄写
husband	n.夫;管家v.持有;使有丈夫
six	n.第六;六
France	n.法兰西
peace	n.和平;和约
low	adj.低的;浅的adv.低;低声地
north	adj.北部的;在北方的adv.向北方n.北;北方
remember	v.记得;牢记
effect	n.感受;结果v.产生;使发生
natural	adj.有关自然的n.智力低下的人
pretty	adj.妙的;漂亮的
fall	n.降落;落下v.砍倒;跌倒
fair	adj.公正的adv.公正地;正面地n.美;女人
service	n.服务v.检修;为...服务
below	adv.在楼下;在下面prep.低于;在...下面
except	prep.除...外conj.除非;除了v.把...除外;反对
hair	n.毛;头发
pass	n.境况;通过v.超过;经过
copyright	n.版权v.以版权保护
do	v.做
army	n.军队;陆军
run	n.跑步;赛跑v.跑;逃
horse	n.马;骑兵v.发情;上马
future	n.将来;前途
open	adj.开着的;空旷的n.旷野;露天v.开;开辟
pleasure	n.高兴;娱乐v.使高兴;觉得高兴
history	n.过去;历史
west	adj.西部的;西方的adv.向西方n.西;西部;西方
pay	n.报偿;付钱v.付;付款
red	adj.红的;通红的n.红;红球
note	n.按语;短笺v.记录;注意
although	conj.虽然;尽管
want	n.缺乏;需要v.缺乏;要
gold	n.金;金币
make	n.牌子;体质v.构成;做
desire	n.要求;愿望v.渴望;要求
play	n.比赛;玩v.开;玩
master	n.艺术家;主人v.精通;统治
office	n.办公室;处
front	adj.前面的;正面的n.前面;正面v.对抗;面向
big	adj.大的;洪亮的adv.成功地;大量地
certainly	adv.当然;无疑地
wind	n.风;圈;气息v.包;绕
receive	v.得到;收到
attention	n.考虑;注意
government	n.政府;政体
church	n.礼拜;礼拜堂
strength	n.力;强度
length	n.长;长段
company	n.公司;群
paper	n.文件;纸v.用纸包起;贴糊墙纸
letter	n.信;字母v.在...上刻字
probably	adv.很可能
glad	adj.高兴的;乐意的
important	adj.重要的;自负的
especial	adj.亲近的;特别的
yourself	pron.你亲自;你自己
fellow	n.男人;人
bear	n.玩具熊;熊v.忍;压
opinion	n.评价;意见
window	n.窗;窗框
faith	n.信任;信条
ago	adv.以前
agreement	n.达成协议;协定
charge	n.价钱;应付v.要;冲锋
beauty	n.美;美人
lip	n.唇状物;嘴唇
remain	v.留下;剩余
arm	n.臂;军种v.提供;武装起来
latter	adj.后者的;较后的
duty	n.责任;职责
send	v.发送;派遣
distance	n.进展;远v.使远离;远远超过
silence	n.寂静;静默v.使安静;压制
foot	n.脚;最下部v.步行;结算
wild	adj.野生的;原始的adv.狂暴地n.野生动物
object	n.对象;物体v.提出;反对
die	n.板牙;模具v.遭受;死
save	prep.除...外v.储蓄;救助
gentleman	n.先生
tree	n.木制用具;树v.在...上植树;爬上树
green	adj.绿色的n.绿色;绿色物v.欺骗;成为绿色
trouble	n.烦恼;困难v.麻烦;折磨
smile	n.欢快;微笑v.露出;惠及
book	n.卷;书v.预订;预订
wrong	adj.不道德的;错误的adv.不适当地;错误地n.错误;坏事v.使丢脸
various	adj.不同的;各个的
sleep	n.昏睡;睡眠v.供...睡觉;睡
person	n.家伙;人
happen	v.发生;碰巧
particular	adj.特定的;特殊的n.详情;一项
minute	adj.快熟的;微小的n.分
hardly	adv.不十分;几乎不
walk	n.行走路程;走v.走遍;走
chief	adj.为首的;主要的n.酋长;首领
chance	adj.偶然的n.机会;机缘v.冒...的险;碰巧
accord	n.谅解;谐和v.授予;相符合
action	n.行动;行为
deal	n.待遇;交易v.发;分配
visit	n.参观;视察v.访问;视察
think	v.想;想像
follow	v.跟随;伴随
stand	n.停住;站立v.经受;容忍
know	v.记住;确知
try	n.尝试v.试;试图
presence	n.出席;进见
heavy	adj.太贵的;重的n.肥畜;重的人
sweet	adj.甜的;悦耳的n.甜食;甜味
plain	adj.单色的;朴素的n.平原;平针
donation	n.捐赠;捐赠物
immediate	adj.立即的;直接的
mouth	n.口;人v.说;做鬼脸
rich	adj.富的;富饶的
month	n.月
afraid	adj.恐惧的;遗憾的
single	adj.单程的;单人的n.单曲唱片;一个v.选出
joy	n.成功;欢欣v.享受;高兴
enemy	n.敌国;敌军
unless	conj.除非
state	n.心情;形态v.陈述;确定
ship	n.船;飞船v.用船运;上船
condition	n.健康状况;状况v.使健康;训练
carry	n.射程;运载v.提;携带
exclaim	v.大声说出;呼喊
fill	n.充分;装填物v.挤满;装满
see	v.察看;看
influence	n.势力;影响v.影响
write	v.记述;写
boy	n.男孩;男子
appear	v.出现;露面
outside	n.外表;外面prep.除了;在...的外面
secret	adj.秘密的;能保密的n.奥秘;秘密
part	n.一部分;组成部分v.放弃;分开
please	adv.请;行v.乐于;敬请
appearance	n.出版;出现
evil	adj.讨厌的;邪恶的n.坏事;祸害
#march	n.3月n.行军;边界v.进展;前进
whatever	pron.不管什么;诸如此类
slow	adj.耗时的;慢的adv.慢慢地v.放慢;放慢速度
tear	n.悲痛;撕v.流泪;撕
horse	n.马;骑兵v.发情;上马
place	n.场所;地方v.放置;得名次
stay	n.逗留;停止v.停止;延迟
instead	adv.反而;作为替代
blue	adj.悲伤的;蓝色的n.蓝色;蓝颜料
impossible	adj.不可能的
period	n.纪;时间
sister	n.姐妹
battle	n.格斗;竞赛v.搏斗;作战
school	n.上学;学校v.教育;控制
occasion	n.时机;时刻v.引起
former	adj.前任的;以前的
food	n.食物;养料
youth	n.青年时期;青年人
learn	v.发现;学
merely	adv.纯粹地;仅仅
reach	n.地带;伸出v.到达;伸出
system	n.系统;制度
twenty	n.第二十;二十
dinner	n.客饭;宴会
quiet	adj.安静的;寂静的n.安静;安宁v.确认;使安静
easily	adv.容易地;无疑
afterwards	adv.以后
walk	n.行走路程;走v.走遍;走
laugh	n.笑;笑柄v.开颜;笑
language	n.全部词汇;语言
expression	n.表达;表示
week	n.工作周;星期
hall	n.会堂;酒
danger	n.危险;危险示意
property	n.财产;地产
wonder	n.惊奇;奇迹v.感到惊讶;感到疑惑
usual	adj.通常的
figure	n.价格;数字v.计算;出现
court	n.法庭;球场v.招致;求爱
general	adj.笼统的;全体的n.将军;上将
show	n.演出;展览v.陈列;给...看
ancient	adj.古代的;古老的n.古钱;旗帜
respect	n.敬意;尊敬v.关于;敬意
third	n.第三;三分之一
worth	adj.值钱的n.价值;经济价值prep.具有...价值;拥有...财产
simple	adj.纯朴的;简单的
tree	n.木制用具;树v.在...上植树;爬上树
remain	v.留下;剩余
society	n.阶层;社会
fight	n.战斗;争吵v.打;奋斗
wall	n.壁;墙v.给...建墙;转动
result	n.获胜;结果v.发生;结果
heaven	n.上天;天
start	n.惊跳;开始v.出现;惊动
command	n.命令;指挥v.俯临;命令
tone	n.音;语气v.增强;调和
regard	n.关系;敬爱v.敬爱;看待
expect	v.等待;预计
mere	adj.纯粹的;只不过的
month	n.月
beside	prep.和...相比;在...旁边
silent	adj.安静的;不作声的
perfect	adj.完好的;完美的v.使精通;使完美
experience	n.经历;经验v.经历
street	n.街;街区
entire	adj.单一的;全部的
fresh	adj.另外的;新的
duke	n.公爵;双手
cover	n.书壳;掩蔽v.盖;代替
east	adj.东部的;在东方的adv.向东方n.东;东部;东方
wood	n.木;木材
stone	n.界石;磨石v.向...扔石块;用石铺
quick	adj.聪敏的;快的adv.紧身地;快n.活肉
notice	n.警告;关注;征象v.警告;提到
bright	adj.聪明的;明亮的adv.光亮地
Christ	n.基督;弥赛亚
boat	n.船v.用船装运;乘船
noble	adj.高尚的;光辉的n.工贼头目;贵族
somewhat	adv.有点
sudden	adj.突然的;迅速的
value	n.价格;价值v.夸耀;尊重
direction	n.管理;指示
chair	n.椅子;主席v.使入座
due	adj.欠款的;应给的adv.正对着n.应缴款;责任
support	n.帮助;支撑v.帮助;支持
date	n.日期;时期v.过期;注有日期
wait	n.等待;幕间时间v.等待;等
Christian	adj.基督的n.基督徒;人
village	n.居民村;乡村
live	adj.活的;真的adv.在现场v.过;活
agree	v.承认;表示同意
line	n.纹路;线v.出局;填
consider	v.考虑;认为
field	n.场地;田v.接;派...上场
scarcely	adv.刚刚;决不
wish	n.请求;希望v.但愿;祝
wait	n.等待;幕间时间v.等待;等
permission	n.允许
success	n.成功;发迹
piece	n.件;片v.接;拼合
form	n.模型;形体v.构成;形成
speaking	n.说话adj.说话的
try	n.尝试v.试;试图
proper	adj.本来的;适宜的
hill	n.小山;斜坡
music	n.音乐;音乐伴奏
German	adj.德国的;德国人的n.德国人;德语
afternoon	n.后期;下午
cry	n.叫喊;哭v.哭;鸣
cost	n.代价;价钱v.价钱为;使付出
allow	v.允给;允许
girl	n.女孩子;女仆
broke	adj.不名一文的
seven	n.第七;七
private	adj.私立的;私人的n.平民;士兵
sit	v.骑;坐
news	n.消息;新闻
top	adj.顶的;最高的n.顶;盖v.盖;结束
scene	n.地点;一场
discover	v.发现;显露
marriage	n.结婚;结婚仪式
step	n.步;步态v.跨;踩
garden	n.公园;花园v.用花园点缀
race	n.比赛;族v.疾走;猛转
begin	v.开始
per	prep.按照;每
individual	adj.独特的;个别的n.个人;人
learn	v.发现;学
political	adj.国家的;政党的
difficult	adj.困难的;难懂的
speech	n.说话;说话方式
lie	n.谎言;躺v.说谎;平卧
cast	n.撒网;投v.投
eat	v.吃;咬
authority	n.当局;权
floor	n.层;底v.击败
ill	adj.不利的;坏的n.病;坏
way	n.方法;方面
officer	n.船长;法警
offer	n.发价;给予v.给予;提出
original	adj.起初的n.原型;原作
happiness	n.恰当;幸福
flower	n.花;精华v.发育;开花
summer	n.夏;大梁v.夏季放牧;过夏天
provide	v.供给;规定
study	n.学科;学习;研究v.记住;学习;研究
religion	n.宗教;宗教教育
picture	n.画v.绘;映出
wall	n.壁;墙v.给...建墙;转动
personal	adj.个人的;亲自的
America	n.美洲
watch	n.手表;守卫v.保卫;等待
leave	n.告别;许可v.丢弃;经过
hot	adj.辣的;热的
effort	n.努力;全部努力
escape	n.逃路;逃跑v.逃脱;漏出
attempt	n.攻击;企图v.企图;引诱
kill	n.击落;杀死v.冻死;杀死
fast	adj.快的adv.快n.禁食;禁食期v.节制饮食;禁食
author	n.发起人;著作者v.发起;著作
brown	adj.肤色深的;棕色的n.棕色v.呈现棕色
pain	n.痛;痛苦
spring	n.弹性;反弹;春天v.惊起;跳
take	n.捕猎;拿v.拿;执住
soldier	n.军事家;士兵
house	n.房屋;棚v.覆盖;住
beneath	adv.在较低处;在下prep.在...底下;在...下方
talk	n.讲话;闲话v.讲;谈论
turning	n.旋转;转弯处
century	n.一百分;百人
step	n.步;步态v.跨;踩
intend	v.想要;意指
soft	adj.轻的;柔滑的adv.柔软地;嘘
straight	adj.整齐的;直的adv.立即;直
matter	n.实体;事情v.化脓;要紧
likely	adj.合适的;可信的adv.很可能
corner	n.包角;角v.垄断;转弯
trademark	n.标记;商标v.用商标标明
justice	n.公正;正确
simply	adv.简单地;仅仅
produce	n.产品;成果v.生;生产
trust	n.信任;信心v.想;信任
appear	v.出现;露面
laugh	n.笑;笑柄v.开颜;笑
forget	v.忘;健忘
Europe	n.欧罗巴洲
passage	n.经过;迁移;通道;走廊
eight	n.八;第八
ourselves	pron.我们亲自;我们自己
give	v.给予;交给
dress	n.衣服;装饰v.布置;穿衣
pass	n.境况;通过v.超过;经过
terrible	adj.可怕的;困难的
medium	adj.中间的n.媒质;手段;巫师
effort	n.努力;全部努力
sake	n.理由;目的
breath	n.呼吸;气息
wise	adj.聪明的;了解的v.教导;知道
possession	n.拥有;有
pleasant	adj.活泼的
perfect	adj.完好的;完美的v.使精通;使完美
memory	n.回忆;记忆
usual	adj.通常的
grave	adj.暗淡的;低沉的n.墓碑;墓穴
fix	n.方位;困境v.定居;固定
modern	adj.近代的;现代化的n.近代
spot	n.疤点;点子v.使有污渍;玷污
troop	n.军队;一群v.成群结队;作伴
rise	n.岗;上涨v.登上;离席
break	n.破裂;破晓v.打破;破坏
fifty	n.第五十;五十
island	n.岛;岛状物
meet	n.集合;集会v.接;遇见
camp	n.兵营;拘留所v.临时安顿;搞同性恋
nation	n.国家;国民
existence	n.存在;发生
reply	n.驳复;回答v.回答;反响
sky	n.苍天;天
touch	n.触;触觉v.触摸;触摸
equal	adj.平等的;平均的n.匹敌者;同等的人v.比得上;相等
fortune	n.富有;好运
shore	n.滨;陆地
domain	n.产业;领土
situation	n.情况;位置
look	n.察看;看v.看
promise	n.可能;允诺v.向...保证;允诺
order	n.次序;整齐v.命令;整理
degree	n.程度;度
middle	adj.中部的;中等的n.中部;中等货
winter	n.冬;寒冷天气v.过冬
plan	n.方法;计划v.计划;设计
allow	v.允给;允许
pale	adj.苍白的;浅的n.尖板条;界限v.使苍白;包围
conduct	n.处理;举止v.表现;处理
religious	adj.宗教的
surprise	n.惊奇;突然袭击v.撞见;惊奇
minute	adj.快熟的;微小的n.分
case	n.框;箱v.探察
lead	n.指引;铅v.牵;致使
move	n.搬家;动v.动;调动
name	n.名字;外号v.把...叫作;给...取名字
stop	n.停止;阻塞v.停止;阻塞
#worse	adv.更坏;更猛烈地bad的比较级
glass	n.玻璃;镜子v.反射;给...装玻璃
board	n.板;纸板v.使搭伙;搭伙
vain	adj.徒劳的;自负的
affair	n.事;事情
instance	n.例子;情况v.举...为例;举例
safe	adj.安全的;谨慎的n.保险箱;家用冰箱
loss	n.减少;损失
doctor	n.巫医;医生v.修改;修理
offer	n.发价;给予v.给予;提出
class	n.班级;课
complete	adj.十足的;完成的v.使完美;完成
access	n.接近;通道v.存取;接近
#lower	v.放下;减低low的比较级
repeat	n.复写;重复v.复述;重复
form	n.模型;形体v.构成;形成
darkness	n.黑暗;无知
military	adj.军人的;军事的n.军人;武装部队
warm	adj.感到热的;温暖的v.取暖;同情
drink	n.喝酒;饮料v.喝
passion	n.激怒;激情
one	n.一;一体
physical	adj.物理的;物质的n.体格检查
example	n.范例;例题
ear	n.耳;穗
question	n.难题;问题v.怀疑;问
start	n.惊跳;开始v.出现;惊动
keep	n.保持;供养v.保管;保守
spite	n.不幸;恶意v.恶意对待
direct	adj.笔直的;直接的adv.径直地v.管理;指示
serious	adj.认真的;严肃的
hat	n.贿赂;帽子
dog	n.公狗;狗v.跟踪;困扰
silver	n.钱;银v.镀银于;变成银色
sufficient	adj.自负的;足够的
main	adj.辽阔的;完全的n.体力;叫数
mention	n.传令嘉奖;提及v.传令嘉奖;提到
servant	n.雇员;仆人
pride	n.骄傲;自豪v.使得意;自豪
crowd	n.群;群众v.挨;挤
train	n.连串;列车v.把...对准;训练
wonderful	adj.精彩的
moral	adj.道德的;有道德的n.典型
instant	adj.紧急的;立即的n.时刻;瞬息
path	n.道路;路
mean	adj.卑鄙的;低劣的n.平均;中间v.意味着;意指
fit	adj.健康的;适合的n.合身;配合v.配合;适合
order	n.次序;整齐v.命令;整理
lot	n.抽签;签
enter	v.参加;登记
rule	n.裁决;规则v.控制;统治
sword	n.剑;权力象征
attack	n.攻击;侵蚀v.攻击
seat	n.坐部;座v.供给...座位;使坐下
game	adj.猎物的;跛的n.游戏;运动v.赌掉;赌博
health	n.健康;卫生
paragraph	n.短文;段落v.写短文
statement	n.陈述;声明
social	adj.社会的n.社会保险;社交聚会
refund	n.退还;退款v.退还
sorry	adj.难过的;内疚的
courage	n.勇敢
member	n.成员;子句
grace	n.风度;善意v.给...增光;使优美
official	adj.公职的;正式的n.官员;行政人员
dream	n.出神;梦v.做;想
worthy	adj.有价值的;值得的n.知名人士
rock	n.大石;矿石v.轻摇使;轻摆
jack	n.老兄;男人v.提高;用篝灯猎
special	adj.特殊的;异常的n.特刊;专列
request	n.需要;要求v.要求
mighty	adj.巨大的;强大的adv.很
glance	n.擦过;闪光v.擦过;反射
head	n.上端;头v.长头;发源
movement	n.动;动作
fee	n.采邑;费
share	n.股份;一份v.分开;分享
expect	v.等待;预计
dollar	n.美元;一元银币
spread	n.翼展;展开v.撒;涂
opposite	adj.对面的;反对的adv.在对面n.对边;对立物prep.在...的对面
glory	n.光荣;赞颂v.吹嘘;骄傲
twelve	n.第十二;十二
space	n.场地;空间v.分隔开;留间隔
engaged	adj.被占用的;忙的
peter	v.逐渐减少
wine	n.葡萄酒;药酒v.喝酒
ordinary	adj.平常的;平庸的n.常任法官;寻常
mountain	n.山;山脉
taste	n.尝;味v.尝;吃
iron	n.铁;熨斗v.熨;熨衣
distribute	v.分;分发
trade	n.交易;贸易v.对换;购物
consider	v.考虑;认为
great	adj.大的;久的n.大人物
accept	v.承认;接受
advantage	n.好处;有利地位v.有利于;获利
idea	n.计划;思想
us	n.美国pron.人们;我们
officer	n.船长;法警
rate	n.比率;费率v.呵责;骂走
clothe	v.覆盖;赋予
sign	n.标志;符号v.签;写下
native	adj.出生的n.当地人;土人
judge	n.法官;鉴定人v.裁决;断定
difference	n.差别;特点
work	n.工作;职业v.经营;工作
anxious	adj.焦虑的
marry	v.娶;结婚
captain	n.船长;领袖v.率领
finish	n.结束;抛光v.结束;用完
extent	n.范围;广度
watch	n.手表;守卫v.保卫;等待
curious	adj.好奇的;奇特的
foreign	adj.对外的;外国的
besides	adv.此外;而且prep.除...之外
method	n.方法;条理
excellent	adj.非常的;较高的
confidence	n.信任;信心
marked	adj.明显的;有标记的
exactly	adv.精确地;正
importance	n.重要;自大
final	adj.决定性的;最后的n.决赛;期终考试
bill	n.清单;帐单v.爱抚;接吻
vast	adj.大量的;高大的
prove	v.表现;证明
fancy	adj.别致的;特级的n.任性;设想v.相信;想象
quick	adj.聪敏的;快的adv.紧身地;快n.活肉
yes	adv.不对;是n.是;赞成票
prevent	v.防止;先去
neck	n.颈肉;颈项v.割颈杀;变狭
heart	n.内心;心
liberty	n.释放;许可
interest	n.利益;趣味v.使参与;使感兴趣
side	n.边;旁边v.同意;赞助
legal	adj.法律的;合法的
dry	adj.干的;干燥的v.使干;变干
serve	n.发球;轮到发球v.任;帮佣
aside	adv.离开;撇开n.离题的话;旁白
pure	adj.纯粹的;纯净的
concerning	prep.关于
lose	v.失去;遗失
power	n.力;能力v.促进
possess	v.具有;拥有
evidence	n.根据;迹象v.显示;证明
distant	adj.冷淡的;远的
progress	n.进步;前进v.改进;前进
similar	adj.相似的;相像的
narrow	adj.勉强的;狭的n.狭谷;狭窄部分v.变狭;缩小
altogether	adv.完全;总共
build	n.体形;构造v.构成;建设
page	n.记录;页v.翻阅;侍侯
particular	adj.特定的;特殊的n.详情;一项
know	v.记住;确知
week	n.工作周;星期
hold	n.拿;船舱v.表现;掌着
mountain	n.山;山脉
search	n.检查;搜查v.探;细察
sad	adj.悲哀的;可悲的
sin	n.过错;罪v.犯;犯过失
lie	n.谎言;躺v.说谎;平卧
proud	adj.感到自豪的
pieces	n.身心崩溃v.拆开
clear	adj.纯色的;清晰的adv.离开着;完全v.扫清;变晴
price	n.贿金;价格v.给...定金;定金
ship	n.船;飞船v.用船运;上船
thirty	n.第三十;三十
sick	adj.病人的;恶心的v.使厌恶
honest	adj.诚实的;真诚的
shut	v.关上;合上
talk	n.讲话;闲话v.讲;谈论
bank	n.岸;堆v.开银行;做庄家
fate	n.命运;天命
judgment	n.判断;审判
condition	n.健康状况;状况v.使健康;训练
accept	v.承认;接受
hill	n.小山;斜坡
forest	n.林区;一丛
measure	n.尺寸;量度v.打量;量
species	n.种;种类
seek	v.试图;去
otherwise	adv.别样;不然
stream	n.河;流v.流;飞奔
honor	n.名誉;荣誉v.使增光;尊敬
careful	adj.关切的;精确的
obtain	v.持有;达到
ear	n.耳;穗
bread	n.面包;食物
bottom	adj.底部的;基础的n.底;枯谷v.使基;基于
additional	adj.添加的
present	adj.出席的;现在的n.现在;礼物v.表示;提出
aid	n.帮助;外援v.帮助
finger	n.手指;指状物v.指出;伸出
remember	v.记得;牢记
choose	v.情愿;欲;挑选
animal	n.动物;畜
event	n.结果
delight	n.高兴;可爱性v.使高兴;感到高兴
right	adj.合适的;正当的adv.好;正当地n.实况;正当v.补救;纠正
amount	n.量;总数v.等同;合计
obtain	v.持有;达到
tax	n.负担;税v.对...收会费;对...征税
servant	n.雇员;仆人
son	n.儿子;女婿
cross	adj.交叉的;相互的adv.横跨地n.十字架v.穿过;交叉
shoulder	n.肩;肩部v.担负;肩起
thick	adj.厚的;密的n.傻瓜
point	n.尖;尖形部件v.显示;指
#stranger	n.陌生人;生手strange的较级
wood	n.木;木材
fact	n.事实;细节
dare	n.大胆;挑战v.敢;敢做
grow	v.种;长
creature	n.人;生物
rain	n.一阵;雨v.下;诉苦
false	adj.不诚实的;不正确的
tall	adj.长的;高的
gate	n.大门;路v.给...装门;用门控制
nation	n.国家;国民
quiet	adj.安静的;寂静的n.安静;安宁v.确认;使安静
surface	n.表面;地面v.使公开化;变得清醒
freely	adv.直爽地;自由地
holy	adj.神圣的;圣洁的
street	n.街;街区
blow	n.吹;花v.吹;吹响
regard	n.关系;敬爱v.敬爱;看待
fashion	n.方式;上流社会v.改变;制作
report	n.报道;报告v.报道;说
coast	n.海岸;滑行v.绕...而行;滑行
daily	adj.每日的;一天的adv.每日n.女佣;日报
file	n.文件夹;锉刀v.发送;锉
shoulder	n.肩;肩部v.担负;肩起
face	n.表面;脸v.面朝;朝
succeed	v.接替;成功
bird	n.鸟;幼鸟
royal	adj.国王的;敕立的n.顶桅帆;王裁
song	n.歌;诗歌
wealth	n.财富;丰富
comfort	n.安慰;盖被v.安慰;帮助
fail	n.不及格;交割失信v.不;缺乏
freedom	n.直爽;自由
peculiar	adj.奇怪的;特殊的
anyone	pron.任何人
advance	adj.先行的;预先的n.前进v.促进;提出
gentle	adj.轻柔的;温和的
sure	adj.可靠的;确信的adv.当然;无疑
animal	n.动物;畜
wait	n.等待;幕间时间v.等待;等
secure	adj.安全的;安心的v.保证;缚牢
grass	n.草;草场
touch	n.触;触觉v.触摸;触摸
draw	n.被拉的量;拉v.拔出;拉
stage	n.舞台;戏剧;阶段v.举办;展现
portion	n.一部分;一份v.把...分给;命定
express	adj.明确的;专门的adv.特意地;用快递n.捷运公司;快车v.表示
open	adj.开着的;空旷的n.旷野;露天v.开;开辟
spirit	n.精神;灵魂v.鼓励;偷偷地走
fish	n.鱼;鱼肉v.捕;捕鱼
tongue	n.舌;语言
capital	adj.首都的;重要的n.首都;资本
angry	adj.发怒的;狂暴的
grow	v.种;长
carriage	n.支架;姿势
weather	n.恶劣天气;天气v.经受风雨;退色
breast	n.胸;胸部v.攀登;以胸撞
presently	adv.不久;当即
snow	n.下雪期;雪v.用雪困住;下雪
paper	n.文件;纸v.用纸包起;贴糊墙纸
necessity	n.必然;必要
practice	n.练习;实践
claim	n.权利;要求v.要求;主张
education	n.教育;教育学
sharp	adj.锋利的;尖的
prince	n.国君;王子
group	n.集体;组v.簇射;形成组
play	n.比赛;玩v.开;玩
throughout	adv.到处prep.遍及
pity	n.可惜;同情v.同情;有同情心
expense	n.花钱;价钱
yours	pron.你的
million	n.百万;许多
add	v.添加;做加法
pray	adv.请v.祈望;做
explain	v.讲解;解释
lead	n.指引;铅v.牵;致使
kill	n.击落;杀死v.冻死;杀死
shadow	n.阴影;影子v.钉...的梢;渐变
companion	n.同伴;职业伴侣
weight	n.重;重量单位v.使负重;使倾斜
mass	n.弥撒;弥撒曲;团v.集中;聚集
establish	v.安置;建立
suffer	v.经受;忍受
gray	n.戈瑞
brave	adj.勇敢的;壮观的n.恶棍;勇敢的人v.向...挑战;吹嘘
thin	adj.薄的;稀薄的;瘦的v.使薄;变薄
check	n.停止;制服v.核对;击退
virtue	n.美德;贞操
golden	adj.含金的;金的
numerous	adj.许多的
frequent	adj.经常的v.常到;交往
famous	adj.第一流的;著名的
tell	v.吩咐;讲
powerful	adj.浓烈的;强壮的
alive	adj.存在的;活着的
waters	n.海域;近海
national	adj.国家的;国民的n.国民;全国总部
weak	adj.不牢固的;虚弱的
divine	adj.敬神的;神的n.神;神学的v.发现;推测
material	adj.身体上的;物质的n.布;材料
principal	adj.主震的;资本的n.为首的人;主要演员
gather	v.收集;积聚
suggest	v.建议;意思是
frank	adj.坦白的n.弗兰克;欧洲人
valley	n.流域;山谷
guess	n.猜测v.猜;想
find	n.发现;发现物v.发现;找出
yellow	adj.发黄的;黄的n.黄;黄色颜料v.使发黄;发黄
heat	n.热;体温v.使热;变热
remain	v.留下;剩余
guard	n.警戒;警卫员v.保守;看守
equal	adj.平等的;平均的n.匹敌者;同等的人v.比得上;相等
natural	adj.有关自然的n.智力低下的人
box	n.箱;巴掌v.打;斗拳
remarkable	adj.非凡的
god	n.上帝n.男神;神
moon	n.月光;月球v.虚度;懒散度日
slight	adj.少量的;纤细的n.冷落;轻视v.忽视;看轻
style	n.派头;样式v.叫
point	n.尖;尖形部件v.显示;指
window	n.窗;窗框
cross	adj.交叉的;相互的adv.横跨地n.十字架v.穿过;交叉
pound	n.磅;镑v.捣碎;剧跳
evident	adj.明显的
principle	n.原则;准则
immediate	adj.立即的;直接的
willing	adj.愿意的
principle	n.原则;准则
character	n.品德;性质
season	n.季;节期v.给...调味;变干燥
remark	n.言辞;注意v.说;注意
science	n.科学;科学事物
tender	adj.嫩的;温柔的n.关怀;交付v.交付;提出
work	n.工作;职业v.经营;工作
whisper	n.低语;微量v.低声说出;低语
interest	n.利益;趣味v.使参与;使感兴趣
quarter	n.四分之一;一刻钟
midst	n.中部prep.在...之中
apparent	adj.表面上的;显然的
bore	n.孔;内膛v.挤出;钻
active	adj.活跃的;积极的n.活跃的人;主动态
aware	adj.懂事的;意识到的
uncle	n.伯父;大伯;舅父
list	n.表;布条v.列举;听
dangerous	adj.引起危险的
august	adj.威严的
calm	adj.安静的;平静的n.安静;镇静v.使平静;平静下来
genius	n.特征;天才
sacred	adj.宗教的
kingdom	n.君主身份;王国
entire	adj.单一的;全部的
popular	adj.民众的
unknown	adj.不知道的n.未知的人;未知元
nice	adj.好的;好看的
habit	n.气质;习惯
familiar	adj.亲近的;熟悉的n.常客;知交
reader	n.读者;教科书
publish	v.出版;发表
direct	adj.笔直的;直接的adv.径直地v.管理;指示
handsome	adj.好看的;慷慨的
join	n.并;连接v.连接;参加
actually	adv.竟然;如今
king	n.大王;君主
post	n.柱;岗位v.宣布;押
approach	n.进路;近似v.近似;靠近
hear	v.听;听见
need	aux.须要n.缺少;需要v.缺少;需要
walk	n.行走路程;走v.走遍;走
twice	adv.两倍;两次
throw	n.冒险;投掷v.发射;投
appoint	v.任命;下令
wisdom	n.明智;知识
number	n.数目;算术v.把...编号;计数
demand	n.需要;要求v.强要;询问
priest	n.祭司;司铎
sorrow	n.悲伤;悔憾v.哀痛;懊悔
drive	n.驾驶;紧迫v.逼迫;赶
fault	n.错误;缺点v.产生断层;犯错误
listen	v.听;听从
palace	n.豪华住宅;王宫
affair	n.事;事情
contact	n.接触;熟人v.使接触;接触
station	n.车站;站v.安置
beat	adj.筋疲力尽的n.跳动v.打;拍打
listen	v.听;听从
fool	n.蠢人;弄臣v.愚弄;玩弄
become	v.适合;变成
watch	n.手表;守卫v.保卫;等待
hurt	n.打击;伤v.弄痛;痛
want	n.缺乏;需要v.缺乏;要
express	adj.明确的;专门的adv.特意地;用快递n.捷运公司;快车v.表示
height	n.高;高处
size	n.尺码;大v.相比;给...上涂料
edge	n.边;刀口v.加边于;使锋利
subject	adj.臣服的;需要...的n.题目;学科v.使臣服;提供
task	n.工作;任务
follow	v.跟随;伴随
interest	n.利益;趣味v.使参与;使感兴趣
nine	n.第九;九
sympathy	n.吊慰;同情
burst	n.爆发;爆炸v.爆发;爆炸
dress	n.衣服;装饰v.布置;穿衣
lift	n.提;天空v.鼓舞;提
hope	n.希望v.希望;相信
suffer	v.经受;忍受
noise	n.声音;噪声
tell	v.吩咐;讲
mind	n.头脑;智力v.记住;照料
#farther	adv.此外;更远地far的比较级
literature	n.文献;文学
vessel	n.船;飞船;容器
affection	n.属性;影响
suffer	v.经受;忍受
proceed	v.进而做;进行
flesh	n.肥胖;肉v.长肉
advice	n.报道;劝告
grand	adj.崇高的;宏伟的n.一千英镑
carry	n.射程;运载v.提;携带
leg	n.假腿;腿
post	n.柱;岗位v.宣布;押
collection	n.募捐;收集
empty	adj.空的;空虚的n.空瓶v.使空;流出
rank	adj.极度肥沃的n.排;行列v.把...分等;级别高于
storm	n.风暴;狂风v.强击;暴怒
imagine	v.猜想;想
pocket	n.一袋;钱袋v.把...围住;皱起
arrival	n.到达;到达者
loud	adj.俗艳的;响亮的adv.大声地
sentence	n.句子;命题v.使遭受;宣判
lovely	adj.心灵美的adv.漂亮地n.美女
happen	v.发生;碰巧
absence	n.缺乏;缺席
breakfast	n.早餐v.进早餐
population	n.全部人;人口
thank	v.感谢;谢谢
rule	n.裁决;规则v.控制;统治
inhabitant	n.居民
series	n.连续;系列演出
laugh	n.笑;笑柄v.开颜;笑
address	n.地址;演说v.对付;呼吁
relief	n.缓解;救济
bird	n.鸟;幼鸟
owner	n.船长;物主
impression	n.压印;印象
coat	n.皮毛;上衣v.在...上涂
prepare	v.准备
relation	n.关系;亲属关系
shape	n.体形;形状v.形成;表规
birth	n.出生;分娩v.产生;生
rapid	adj.陡的;快的n.急流
smoke	n.抽烟;烟v.抽;熏制
January	n.一月
machine	n.机动车;机器v.使定型
content	adj.高兴的;满意的n.内容;满意v.使满意
regular	adj.定时的;恒常的n.常客;正规兵
stand	n.停住;站立v.经受;容忍
wholly	adv.全部地;完全地
busy	adj.忙的v.使忙于;忙碌
treat	n.款待;乐事v.对待;看待
burning	adj.发热的;燃烧的
shame	n.羞耻;羞辱v.感到羞耻
quality	n.品德;性质
bay	adj.枣红色的n.湾;坝v.对...吠叫;大声叫嚷
discover	v.发现;显露
inside	n.里面;内脏prep.在...的肚内;在...里面
brain	n.脑;脑袋v.重击...的头
soil	n.大地;国土v.腐蚀;弄脏
complete	adj.十足的;完成的v.使完美;完成
message	n.启示;信息v.通报
ring	n.戒指;金环v.发;鸣
call	n.号声;呼叫v.呼唤;叫
phrase	n.短语;话语v.措词;分成短句
act	n.幕;行为v.扮演;演
mention	n.传令嘉奖;提及v.传令嘉奖;提到
square	adj.成直角的;正方形的adv.成正方形;成直角n.方格;广场v.符合;结清
pair	n.一双;一条v.成对;配合
title	n.标题;一种v.给...加标题;授予...称号
understand	v.得知;理解
Sunday	n.星期天
fruit	n.果实;水果v.使结果实;结果实
mad	adj.发狂似的;疯的
force	n.力;武力v.强迫;逼叫
tea	n.茶;茶叶
rock	n.大石;矿石v.轻摇使;轻摆
slave	n.奴隶v.使从属;使做奴隶
fall	n.降落;落下v.砍倒;跌倒
absolute	adj.纯粹的;道地的n.绝对;绝对事物
slow	adj.耗时的;慢的adv.慢慢地v.放慢;放慢速度
bear	n.玩具熊;熊v.忍;压
mercy	n.慈悲;宽大处理
explain	v.讲解;解释
contain	v.包含;可包含
grief	n.悲伤;不幸
soldier	n.军事家;士兵
previous	adj.过早的;以前的
welcome	adj.被允许的;受欢迎的n.欢迎;欢迎的话v.欢迎;迎接
prayer	n.祷告;祷文
star	n.星;星宿v.用星装饰;当明星
belief	n.相信;信念
inform	v.通知;告发
moment	n.片刻;时机
poetry	n.诗;诗的特征
constant	adj.不断的;忠实的n.常数;常项
buy	n.购买v.获得;买
final	adj.决定性的;最后的n.决赛;期终考试
faithful	adj.尽职的;忠实的n.忠实信徒;虔诚徒众
ride	n.骑;骑马道v.骑;乘坐
policy	n.方针;计谋
supper	n.晚餐
draw	n.被拉的量;拉v.拔出;拉
excitement	n.刺激;激动
demand	n.需要;要求v.强要;询问
fight	n.战斗;争吵v.打;奋斗
field	n.场地;田v.接;派...上场
drove	n.人群;畜群
upper	adj.北部的;较高的n.上铺;鞋帮
sum	n.和;总数v.总结;共计
motion	n.动;提议v.摆动;做手势
assistance	n.帮助;补助
forty	n.第四十;四十
stone	n.界石;磨石v.向...扔石块;用石铺
fee	n.采邑;费
kindly	adj.仁慈的;温和的adv.仁慈地;衷心地
dignity	n.官阶;庄严
catch	n.捕获物;抓v.接住;抓住
seat	n.坐部;座v.供给...座位;使坐下
knee	n.膝部;膝关节v.向...下跪
current	adj.流动的;通行的n.电流;流
send	v.发送;派遣
object	n.对象;物体v.提出;反对
gain	n.获得;增加v.获得;增加
bitter	adj.有苦味的n.苦;苦味
possibly	adv.无论如何;也许
slave	n.奴隶v.使从属;使做奴隶
separate	adj.不同的;分开的v.分割;分隔
loose	adj.放松的;宽松的adv.宽松地v.解开;释放
text	n.课文;课本
don	n.先生v.披上
credit	n.信任;信誉v.把...归于;信任
hop	n.毒品;忽布v.飞越;跳过
print	n.印刷;印刷品v.打上;印
feature	n.脸型;面貌v.是...的特色;以...为特色
fond	adj.喜爱的
control	n.管制;指挥v.统制;抑制
capable	adj.有能力的
fifteen	n.第十五;十五
firm	adj.坚定的;坚固的n.工作小组;商号v.确认;变硬
superior	adj.较大的;较高的n.上级;占优势者
cruel	adj.残忍的;严格的
spiritual	adj.精神的n.黑人的圣歌
harry	n.袭击v.烦扰;袭击
splendid	adj.有光彩的;壮丽的
proof	n.证据;证明v.检验;校对
press	n.按;压力v.按;挤出
join	n.并;连接v.连接;参加
process	n.步骤;过程v.对...起诉;列队行进
crime	n.犯罪;罪
dust	n.地面;粉v.擦去;沾上灰
instantly	adv.立即;迫切地conj.一...
land	n.地产;陆地v.靠岸;落下
relation	n.关系;亲属关系
door	n.门;门状物
concern	n.公司;关心v.涉及;使挂念
deep	adj.深的;有...深的adv.强烈地;深深地n.海;海渊
practical	adj.可实施的;实践的
sing	v.唱;啼
destroy	v.打破;破坏
anger	n.怒;痛苦v.使发怒;发怒
result	n.获胜;结果v.发生;结果
increase	n.放大;增加v.放;增加
reason	n.理由;理智v.劝喻;讨论
nose	n.鼻子;气味v.探出;嗅
friendly	adj.朋友的;友善的adv.友好地
entrance	n.进入;入口v.使狂喜
room	n.房间;一套房间v.占一房间
admit	v.承认;接受
supply	n.供应;供应量v.供给;弥补
clean	adj.纯洁的;清洁的adv.干净地;完全地v.剥光;被打扫
useful	adj.有用的
yesterday	n.昨日;昔日
delicate	adj.柔和的;鲜美的
fail	n.不及格;交割失信v.不;缺乏
continue	v.继续;延伸
remove	v.调动;脱下
address	n.地址;演说v.对付;呼吁
choice	adj.上等的;中上级的n.选择;选择时机
huge	adj.庞大的
need	aux.须要n.缺少;需要v.缺少;需要
wear	n.穿;服装v.穿着;蓄
blind	adj.盲人的;瞎的adv.盲目地;轻率地n.眼罩;遮蔽物v.比...更亮;使瞎
unable	adj.不能的;赢弱的
cover	n.书壳;掩蔽v.盖;代替
double	adj.两倍的;双的adv.两倍地;双双地n.酷似的人;两倍v.握紧;代替
victory	n.成功;胜利
dozen	n.打;许多
constant	adj.不断的;忠实的n.常数;常项
level	adj.平的;一般高的n.基准面;水平面v.击倒;瞄准
release	n.发泄;放v.发泄;放出
rough	adj.不平滑的;未加工的n.粗人v.对...动粗;使不平
end	n.端;终止v.结束;胜过
show	n.演出;展览v.陈列;给...看
fly	n.苍蝇v.使飞;飞
praise	n.赞美;赞扬v.评价;赞颂
devil	n.恶棍;魔鬼v.给律师当助手
ahead	adv.向前;在将来
smith	n.创造者;锻工;工匠
connect	v.联系;连接
degree	n.程度;度
gain	n.获得;增加v.获得;增加
addition	n.加;增加的人
chamber	adj.室内的;私人的n.会议厅;室v.装
note	n.按语;短笺v.记录;注意
gradual	adj.不陡的;渐渐的
soul	n.精神;灵魂
mission	n.传教团;外交使团
sacrifice	n.祭品;献祭v.牺牲;献祭
mistake	n.错误;误解v.误解;误认
exercise	n.履行;运动v.履行;训练
conscience	n.良心;意识
car	n.车厢;小汽车
theory	n.理论;学说
command	n.命令;指挥v.俯临;命令
nobody	pron.没有人
minister	n.部长;公使v.敷;供给
close	adj.紧的;近的adv.接近地n.结束;终止v.关;关
energy	n.活力;能
bare	adj.赤裸的;光秃的v.揭露;使赤裸
part	n.一部分;组成部分v.放弃;分开
mistress	n.主妇
hate	n.仇恨v.不愿;仇恨
play	n.比赛;玩v.开;玩
color	n.颜色v.变色;脸红
lake	n.池;湖
safety	n.安全;无损
provision	n.供应;条文v.向...供应食品和其他必需品
asleep	adj.长眠的;麻木的
centre	n.心;正中v.集中;居中
faint	adj.微小的;无力的n.昏厥v.变得微弱;昏厥
think	v.想;想像
parent	n.父亲;祖先v.做...的父亲
careful	adj.关切的;精确的
enjoy	v.经历;享有
drop	n.滴;微量v.滴
brilliant	adj.光辉的;卓越的n.最小号铅字
brief	adj.短暂的;距离短的n.辩护状;概要v.作...的提要
bring	v.促使;出产
worship	n.崇拜;敬神v.崇拜;敬奉
goods	n.货物;衣料
tale	n.陈述;故事
skin	n.皮;外皮v.剥去...的皮;蜕皮
roof	n.顶;房屋v.给...装以特定屋面
grey	adj.灰色的n.灰色;坯布v.成为灰色
high	adj.高的;高地的adv.高;高价的n.高地;高峰
crown	n.王冠;王位v.给...戴上;露顶
castle	n.藏身所;城堡v.王车易位
throne	n.宝座;君王v.登上王位
despair	n.绝望v.对...绝望;绝望
ease	n.安适;容易v.放松;解除
attach	v.系;附属
total	adj.完全的;总的n.总数v.总数达;总计
kindness	n.仁慈
mile	n.英里
citizen	n.公民;平民
circle	n.环状物;圆v.绕过;围着
dull	adj.隐约的;愚钝的v.减轻;变钝
extreme	adj.极大的;极端的n.极度;极端
cloud	n.一大群;云v.覆盖;弄暗
figure	n.价格;数字v.计算;出现
intention	n.意思;意图
prison	n.监狱;牢狱v.监禁
term	n.词;期v.把...称为
thorough	adj.彻底的
cup	n.杯;杯子v.用杯盛;拔火罐
member	n.成员;子句
civil	adj.公民的;国内的
apply	v.涂;应用
labor	n.工作;劳动v.劳动;努力
everywhere	pron.每一处
strike	n.罢工;打v.打;敲
fair	adj.公正的adv.公正地;正面地n.美;女人
comply	v.遵从
fellow	n.男人;人
event	n.结果
gently	adv.缓慢地;平缓的
connection	n.联系;连接
protection	n.保护;保护者
conscious	n.意识;有意的
edition	n.版本
direct	adj.笔直的;直接的adv.径直地v.管理;指示
pull	n.拉;拉力v.采;拉
flight	n.飞翔;抽逃
evident	adj.明显的
surround	v.包围;围住
yard	n.码;庭院;场地
voice	n.禽鸣声;说话声v.给...整音;说
weary	adj.疲劳的;厌倦的v.渴望;疲劳
couple	adj.两个n.夫妻;一对v.联想;连接
variety	n.变化;种类
whilst	conj.直到
volume	n.音量;卷;体积
detail	n.细部;细节v.列举;详述
custom	n.光顾;习惯
apart	adv.成距离;成零碎
bow	n.弓;虹v.弯曲;鞠躬
awful	adj.使人畏惧的adv.十分
everybody	pron.每人
ask	v.问
lover	n.爱人;情夫
show	n.演出;展览v.陈列;给...看
suit	n.套;衣服v.适合;合适
plan	n.方法;计划v.计划;设计
render	v.付给;给予
picture	n.画v.绘;映出
lest	conj.唯恐
volunteer	adj.志愿的;自生的n.志愿兵;自愿者v.自愿;自愿提供
sing	v.唱;啼
eager	adj.敏锐的;热切的
precious	adj.贵重的adv.极其n.珍爱的人
require	v.想要;需要
meat	n.肉;食物
whenever	adv.无论什么时候conj.无论什么时候
milk	n.奶;乳剂v.抽取;出奶
dog	n.公狗;狗v.跟踪;困扰
successful	adj.成功的;有成就的
plant	n.秧苗;植物v.插;种
vision	n.幻觉;看;视觉
rare	adj.稀薄的;稀有的adv.很v.渴望
grant	n.给予;授予物v.承认;授予
raise	n.高岗;提高v.举起;竖起
manner	n.方式;态度
cousin	n.堂兄弟;远亲
cool	adj.冷静的;凉的n.冷淡;冷静v.变凉;减缓
trial	adj.审讯的;试验的n.麻烦;试
learn	v.发现;学
approach	n.进路;近似v.近似;靠近
bridge	n.鼻梁;桥v.架桥于;跨越
abroad	adv.到国外;出国
pay	n.报偿;付钱v.付;付款
literary	adj.书面的;文学的
writer	n.执笔者;作者
disappear	v.使不见;消失
interrupt	n.隔阂;中断v.打断;中止
stock	n.砧木;主干;储备v.备货;发肿
reader	n.读者;教科书
dreadful	adj.可怕的;糟透了的n.廉价刺激性小说
female	adj.雌的;女的n.雌性动物;女子
protect	v.保护
accustom	v.使习惯于
type	n.类型v.翻印;打字
salt	n.盐;盐状物v.撒盐于...上;以盐喂
destroy	v.打破;破坏
sign	n.标志;符号v.签;写下
innocent	adj.率真的;清白的n.无罪的人;新手
temper	n.性情;脾气v.回火;缓和
plenty	adj.很多的adv.充分地n.丰富;富裕
avoid	v.避开;避免
represent	v.代表;使有代表
favor	n.得宠;恩惠v.赐与;喜爱
mental	adj.精神的;颏的
attitude	n.态度;姿势
return	n.回;送回v.回报;回
admiration	n.惊奇;钦佩
brother	n.兄弟;挚友
anxiety	n.焦虑;渴望
queen	n.酋长夫人;王后
teach	v.教;教导
count	n.计算;数数v.数;值
curiosity	n.好奇;奇物
solemn	adj.隆重的;严肃的
cause	n.理由;事业v.使;使产生
vessel	n.船;飞船;容器
dance	n.跳舞;舞v.舞;舞动
hotel	n.饭店;公馆
wicked	adj.坏的;淘气的
kiss	n.轻拂;吻v.轻拂;吻
gun	n.鸣放;炮v.向...开枪;加大油门
fill	n.充分;装填物v.挤满;装满
visible	adj.明显的;现有的
guide	n.导游;向导v.操纵;给...领路
earnest	adj.认真的;重要的n.保证;定金
actual	adj.实际的;现行的
companion	n.同伴;职业伴侣
prisoner	n.犯人;刑事被告
miserable	adj.贫困的;痛苦的n.遭受苦难的人
lad	n.家伙;男孩
harm	n.损害;邪恶v.损害
view	n.观看;视力v.查看;观看
utter	adj.绝对的;完全的v.发出;发射
end	n.端;终止v.结束;胜过
shop	n.购物;商店;营业v.选购;浏览
stair	n.楼梯;梯级
pardon	n.饶恕;赦免v.免除;赦免
gay	adj.欢快的adv.很;卖弄地
beg	v.恳求;请
seldom	adv.不常
kind	adj.和蔼的;友好的n.类;种类
record	n.记录;履历v.登记;记录
fat	adj.肥胖的;育肥的n.肥肉;脂肪
sand	n.沙;沙滩v.撒沙于;沙淤
violent	adj.暴力的;狂热的
flat	adj.瘪的;平的adv.平直地;完全地n.平面;一层
departure	n.背离;开始
deliver	v.交出;投递
gift	n.礼物;赠送
ruin	n.毁灭;破产v.毁坏;毁灭
skill	n.技术;熟练性
cattle	n.大众;牛
equipment	n.才能;配备
temple	n.教堂;圣堂
call	n.号声;呼叫v.呼唤;叫
license	v.批准;准许
visit	n.参观;视察v.访问;视察
consent	n.融洽;同意v.同意;一致
sufficient	adj.自负的;足够的
native	adj.出生的n.当地人;土人
laughter	n.笑;笑意
contain	v.包含;可包含
scattered	adj.分散的;散射的
whence	adv.从何处;从那里conj.据此
rush	n.冲;匆忙v.猛推;冲
chief	adj.为首的;主要的n.酋长;首领
bold	adj.冒失的;勇敢的n.黑体
anywhere	pron.任何地方
witness	n.证据;证人v.目击;作证
foolish	adj.发窘的;荒谬的
help	n.帮助;补救办法v.帮助;助
kitchen	n.厨房;厨师
sell	n.欺骗;推销v.出卖;卖
anybody	pron.任何人
self	n.本性;私利
extreme	adj.极大的;极端的n.极度;极端
treatment	n.处理;对待
throat	n.嗓音;咽
dream	n.出神;梦v.做;想
patient	adj.忍耐的;有耐心的n.病人;顾客
speed	n.快;速率v.促进;快走
growth	n.生长;增长
quantity	n.大量;量
immense	adj.广大的;无限的
conclusion	n.结论;结尾
computer	n.计算机;计算器
affect	n.内心倾向;自觉感情v.打动;侵袭
severe	adj.尖锐的;严肃的
excuse	n.藉口;歉意v.为...辩解;原谅
triumph	n.胜利;喜悦v.征服;获胜
origin	n.出身;起端
eternal	adj.永恒的;永久的n.上帝
audience	n.读者;观众
page	n.记录;页v.翻阅;侍侯
sound	adj.健康的;牢固的n.声;音v.宣告;发音
swift	adj.迅速的n.褐雨燕
limit	n.范围;限度v.限定;限制
wing	n.翅;翅膀v.飞过;飞
service	n.服务v.检修;为...服务
library	n.书房;图书馆
remain	v.留下;剩余
contain	v.包含;可包含
base	adj.基础的;卑劣的n.基;基础v.驻扎;作...的基础
confusion	n.困惑;骚乱
win	n.胜利;赢得物v.赢得;成功
maid	n.处女;少女
charm	n.美貌;魅力v.使高兴;行魔法
edition	n.版本
attend	v.出席;侍候
soft	adj.轻的;柔滑的adv.柔软地;嘘
reality	n.实在;现实
perform	v.履行;做
glorious	adj.光荣的;壮丽的
likewise	adv.同样地;也
site	n.地方;地皮v.给...择址;设置
sail	n.帆;帆船v.驾驶;漂浮
frighten	v.使惊恐
acquaint	v.使认识
unhappy	adj.不恰当的;不幸的
fear	n.害怕;可能性v.害怕;恐怕
article	n.契约;条款;物品;冠词v.列举;进行控告
prisoner	n.犯人;刑事被告
store	n.储存;大量v.储备;装满
adopt	v.采取;继承
remark	n.言辞;注意v.说;注意
cook	n.厨子;蒸煮v.烹调;烧
thousand	n.第一千;一千
pause	n.停顿;暂停v.踌躇;暂停
band	n.群;箍v.聚集
valuable	adj.贵重的;有价值的n.贵重物品
hence	adv.去;因此
desert	n.荒漠;沙漠v.背离;抛弃
effect	n.感受;结果v.产生;使发生
kiss	n.轻拂;吻v.轻拂;吻
plant	n.秧苗;植物v.插;种
ice	n.冰;冰状物v.使凉;结冰
ball	n.球;舞会v.交媾;狂欢
stick	n.棍;木条v.刺;停留
absolute	adj.纯粹的;道地的n.绝对;绝对事物
readily	adv.乐意地;迅速地
behold	v.看;注视
fierce	adj.狂热的;猛烈的
argument	n.理由;说理
observe	v.观察;说
bless	v.使神圣;为...祝福
bosom	adj.胸的;知心的n.乳房;胸v.抱
rage	n.狂暴;狂怒v.发怒;狂吹
discovery	n.发现;泄露
creature	n.人;生物
shout	n.呼喊v.呼喊;叫嚷
guilty	adj.有过失的;有罪的
punishment	n.罚
gun	n.鸣放;炮v.向...开枪;加大油门
slight	adj.少量的;纤细的n.冷落;轻视v.忽视;看轻
article	n.契约;条款;物品;冠词v.列举;进行控告
police	n.警察;警察部门v.管理
mysterious	adj.神秘的
extend	v.扩展;伸
confess	v.坦白;忏悔
shade	n.荫;阴暗v.隐瞒;遮
murder	n.谋杀;破坏v.扼杀;谋杀
emotion	n.动;情感
wonder	n.惊奇;奇迹v.感到惊讶;感到疑惑
hide	n.皮肤;生命v.隐瞒;遮掩
expedition	n.出征;旅行
horror	n.恐怖;恐怖性
local	adj.局部的;位置的n.当地居民;市郊列车
expense	n.花钱;价钱
ignorant	adj.不知道的;无知的
doctrine	n.教诲;教义
generous	adj.大的;慷慨的
range	n.级别;排;山脉v.排列;变动
host	n.主人;军队v.招待;群集
wet	adj.多雨的;湿的n.湿气;雨v.尿湿;变湿
cloud	n.一大群;云v.覆盖;弄暗
mystery	n.奥秘;神秘
waste	n.废料;浪费v.浪费;消耗
change	n.改变;更动v.改变;换去
possess	v.具有;拥有
disease	n.病;病害
former	adj.前任的;以前的
spend	v.花;用
production	n.产品;产生
source	n.出处;源
mankind	n.男子;人类
universal	adj.全体的;宇宙的n.共相;谓项
deck	n.甲板;桥面v.击倒;装饰
see	v.察看;看
habit	n.气质;习惯
estate	n.地产
aunt	n.阿姨;伯母
reign	n.统治;主宰v.盛行;为王
humble	adj.谦逊的v.使谦逊
compliance	n.柔量;顺从
delay	n.延迟v.耽搁
shin	n.胫;胫骨v.攀;快步走
report	n.报道;报告v.报道;说
hers	pron.她的
midnight	n.半夜十二点钟;漆黑
listen	v.听;听从
flower	n.花;精华v.发育;开花
hero	n.男主角;英雄
accomplish	v.达到;实现
thank	v.感谢;谢谢
bank	n.岸;堆v.开银行;做庄家
philosophy	n.哲理;哲学
belong	v.合适;属
finger	n.手指;指状物v.指出;伸出
market	n.集市;市场v.销售;进行交易
cap	n.便帽;根冠v.覆盖;给...带帽
wave	n.波;高潮;挥手;浪v.招手;波动;飘摇
pick	n.掏;凿v.掏;凿
purpose	n.目的;效用
somewhere	pron.某处
delight	n.高兴;可爱性v.使高兴;感到高兴
push	n.突出;推v.推;突出
press	n.按;压力v.按;挤出
household	n.王室;一家人
fleet	adj.短暂的;浅的n.船队;海军
baby	n.婴儿;幼畜v.轻击
region	n.地区;各地区
lately	adv.近来
utter	adj.绝对的;完全的v.发出;发射
exact	adj.精密的;精确的v.索取;要求
image	n.外形;像v.想象;造像
age	n.成年;年龄v.使老;变陈
murmur	n.细声;小声话语v.小声抱怨;小声说
melancholy	adj.忧郁的n.忧思;忧郁
suspicion	n.怀疑;一点儿v.怀疑
bow	n.弓;虹v.弯曲;鞠躬
refuse	n.废料v.拒不;拒绝
staff	n.工作班子;全体职员v.雇用
liability	n.倾向;责任
enjoy	v.经历;享有
stretch	n.舒展;延伸v.拉直;舒展
gaze	n.凝视v.盯着看
belong	v.合适;属
ashamed	adj.惭愧的
reward	n.报答;酬金v.报答;酬谢
meal	n.挤奶;进餐
blame	n.责任;指责v.指责;诅咒
status	n.地位;法律地位
opinion	n.评价;意见
indicate	v.标示;表明
poem	n.诗
savage	adj.不文明的;凶恶的n.粗鲁的人;野蛮人v.激怒;乱咬
arise	v.起立;上升;出现;发生
voyage	n.航程;航海v.航行越过;航海
misery	n.疼痛;痛苦
guest	n.客;旅客
paint	n.涂漆;颜料v.画;描写
attend	v.出席;侍候
afford	v.买得起;提供
donate	v.放出;捐
job	n.工作;职业
proceed	v.进而做;进行
love	n.爱;爱情v.爱;恋爱
regret	n.懊悔;道歉v.痛惜;因...懊悔
plain	adj.单色的;朴素的n.平原;平针
risk	n.危险;危险率v.把...作赌注;冒...的危险
ad	n.作广告
light	adj.淡色的;轻的adv.轻装地n.光;光感v.点;照亮
angel	n.安琪儿;天使
rapid	adj.陡的;快的n.急流
distinct	adj.明显的;有区别的
doubtless	adj.无疑的adv.公认地;无疑地
proper	adj.本来的;适宜的
wit	n.风趣;智力v.知道
fame	n.传闻;名声
singular	adj.独一的;非凡的
error	n.错误;谬见
utmost	adj.极度的;最远的n.极限
method	n.方法;条理
reputation	n.好名声;名气
appeal	n.呼吁;上诉v.控告;呼吁
strong	adj.极大的;强壮的adv.强烈地;强有力地
lack	n.缺乏;需要v.短少;缺乏
break	n.破裂;破晓v.打破;破坏
dawn	n.开端;黎明v.开始;破晓
violence	n.暴力;猛劲
fatal	adj.致命的;重大的
render	v.付给;给予
career	n.成功;全速;职业;专业v.使奔驰;奔驰adj.职业的
design	n.设计;图案v.决意;谋划
display	n.展览;展示v.陈列;炫耀
get	v.获得;取得
commercial	adj.商品的;商业的n.商业广告;宣传
forgive	v.豁免;容许
light	adj.淡色的;轻的adv.轻装地n.光;光感v.点;照亮
agreeable	adj.适合的;同意的
suggestion	n.暗示;建议
utter	adj.绝对的;完全的v.发出;发射
sheep	n.羊;羊皮革
resolution	n.决心;判决
spare	adj.备用的;剩下的n.备件;姘妇v.节约;宽容
patience	n.坚忍;忍耐
domestic	adj.非野生的;家的n.国货;家仆
farm	n.农场;饲养场v.耕作;种植
reference	n.参照;引文出处v.提出...作参考
exist	v.存在;发生
corn	n.谷粒;鸡眼
approach	n.进路;近似v.近似;靠近
alike	adj.同样的adv.一样地
mount	n.登;山v.登上;登
issue	n.河口;结果v.发行;分配
key	n.答案;方法v.为...调音;钉防
majority	n.多数;多数党
measure	n.尺寸;量度v.打量;量
town	n.城市;镇
flame	n.光辉;火焰v.变热;发光
ignorance	n.不知;无知
occasional	adj.临时的;偶尔的
weakness	n.爱好;弱点;软弱
furnish	v.供应;装设备于
priest	n.祭司;司铎
flying	adj.飞的;飞似的
cloth	n.布;桌布
profit	n.利;利益v.得益;获利
bell	n.钟;钟声v.鸣钟;吼叫
hitherto	adv.到这儿;迄今
benefit	n.义演;益处v.有益于;得益
movement	n.动;动作
eager	adj.敏锐的;热切的
act	n.幕;行为v.扮演;演
atmosphere	n.大气;空气;大气层
chapter	n.章;重要章节
hole	n.巢穴;洞v.打;打洞
depart	v.离开;死
catholic	adj.罗马天主教的n.罗马天主教徒adj.广泛的;宽容的n.扒手
file	n.文件夹;锉刀v.发送;锉
reasonable	adj.公平的;正当的
sugar	n.食糖;糖
sigh	n.叹气v.悲叹;渴望
humanity	n.人道;人类
thrust	n.猛推;要点v.插;刺
frame	n.车架;构架v.构筑;制订
opposition	n.敌对;反对
disk	n.花盘;盘
haste	n.草率;急迫
lonely	adj.孤独的;寂寞的
artist	n.能手;艺术家
knight	n.爵士;骑士v.授...以爵士品位
quarter	n.四分之一;一刻钟
charm	n.美貌;魅力v.使高兴;行魔法
substance	n.实质;物质
roll	n.小圆面包;一卷v.卷;推
division	n.分;分配
slavery	n.奴隶身份;奴隶制
verse	n.韵文;诗;节v.使熟练
decision	n.决定;决议
probable	adj.有充分根据的
painful	adj.困难的;疼痛的
governor	n.长官;州长
forever	adv.老是;永远
turn	n.翻动;旋动v.翻动;旋动
branch	n.分部;树枝v.出枝;分支
ocean	n.海洋;海
rear	adj.后部的;后方的n.后部;后方v.抚养;竖起
leader	n.领先者;领袖
star	n.星;星宿v.用星装饰;当明星
boat	n.船v.用船装运;乘船
keen	adj.刺人的;锋利的
sense	n.感官;感觉v.检测;了解
occasion	n.时机;时刻v.引起
readable	adj.易辨认的;易读的
beloved	adj.受爱戴的;所钟爱的n.心爱的人
bone	n.骨;骨质v.施骨肥于;苦学
enthusiasm	n.热心;宗教狂热
material	adj.身体上的;物质的n.布;材料
luck	n.好运;运气v.凑巧碰上;逢凶化吉
community	n.社会;团体
apparent	adj.表面上的;显然的
hurry	n.急忙;渴望v.急派;赶紧
scheme	n.计划;系统v.计划;密谋
oil	n.石油;油v.溜;融化
thence	adv.所以;之后
reach	n.地带;伸出v.到达;伸出
dim	adj.暗淡的;差的n.昏暗;减光v.使暗淡;使减光
wretched	adj.不幸的;极坏的
hang	v.吊死;悬挂
pipe	n.管子;烟斗v.吹奏;发尖声
useless	adj.差劲的;无益的
print	n.印刷;印刷品v.打上;印
smooth	adj.光溜的;磨平的v.弄平;铺平
solid	adj.固体的;牢固的adv.肯定;全部地n.固体;固形物
build	n.体形;构造v.构成;建设
attempt	n.攻击;企图v.企图;引诱
egg	n.蛋;人v.向...扔蛋;鼓励
equivalent	adj.等价的;同解的n.当量;相等物
burn	n.燃烧;烧伤v.点燃;烧掉
recent	adj.全新世的;最近的
travel	n.旅行;漫游v.经过;旅行
noon	n.午夜;正午
cry	n.叫喊;哭v.哭;鸣
generation	n.产生;代
cabin	n.房舱;棚屋
hand	n.脚;手v.搀扶;交
cease	n.停止v.停止;停
tent	n.帐篷;帷幕v.观察;注意
frequent	adj.经常的v.常到;交往
alarm	n.惊恐;警报v.打扰;使惊恐
nervous	adj.神经的;神经质的
beast	n.动物;畜生
aloud	adv.出声地;大声的
