scour	n.擦;除垢剂v.擦掉;擦
thirtieth	n.第三十;第三十日
comment	n.批评;闲话v.评论;注释
gala	adj.节日的n.节日;节日服装
segment	n.部分;段v.分割;细胞分裂
sharpen	v.加重;削尖
socialist	adj.社会党的n.社会党人
vanquish	v.征服
gull	n.妓女;鸥v.欺骗
rob	v.盗窃;抢
antiquary	n.古文物收藏家
brood	n.全体孩子;一类v.孵;想
cancel	v.抵消;取消
drastic	adj.激烈的;严厉的
etymology	n.阐述词源;同源学
cherub	n.漂亮的孩子;小天使
filter	n.滤器;去尘器v.过滤;滤出
meter	n.计;邮资机v.用计计量;用表计量
gnaw	v.咬
trickle	n.滴;涓滴v.使滴;滴
brigand	n.土匪;违法
colonnade	n.成行的树;柱廊
fender	n.挡泥板;防御物
mince	n.切碎的食物v.切碎;细分
tumult	n.波动;吵闹
hump	n.驼背;驼峰v.溜放;隆起
copious	adj.多产的;丰富的
decadence	n.堕落
sporadic	adj.分散的;孤立的
widen	v.加宽;变宽
deduce	v.演绎
illuminate	adj.被照亮的v.阐明;照明
hurrah	adv.好n.激动;叫好声
braid	n.辫子;穗带v.编结;镶缀
egress	n.出口;外出v.出
floral	adj.福罗拉的;花的
beck	n.点头;鞠躬v.向...示意;示意
diaphragm	n.隔板;膈
tablecloth	n.桌布
extraneous	adj.额外的;体外的
proficient	adj.熟练的n.能手
depress	v.按下;使抑郁
gag	n.塞口物;石斑鱼v.戏弄;窒息
mister	n.平民;先生
uncover	v.揭露;揭去盖子
umpire	n.裁判员;仲裁人v.当裁判员
human	adj.人的;似人类的n.人
surmount	v.克服;优于
atomic	adj.原子的;原子能的
pianist	n.钢琴家
apple	n.苹果
wetting	n.润湿;遗尿
curvature	n.曲;曲率
infuse	v.泡;被泡
emit	v.发表;发出
engross	v.正式写成
queen	n.酋长夫人;王后
kerosene	n.煤油
twitch	n.抽动;抽痛v.急拉;夹
barrack	n.棚屋;营房v.大声鼓噪
bet	n.打赌;赌金v.敢说;打赌
uplift	n.上升;抬起v.抬起;提高
forceful	adj.强有力的
drone	n.懒汉;雄蜂v.懒散地度;嗡嗡叫
locomotion	n.旅行;运动
muddle	n.糊涂状态;混乱状态v.把...弄糟;使糊涂
proffer	n.提供v.提供
sediment	n.沉积;沉积物v.使沉积;沉积
snub	adj.制动用的n.冷落v.冷落;严厉斥责
complete	adj.十足的;完成的v.使完美;完成
mongrel	adj.混杂的;杂种的n.杂种;杂种狗
crumb	n.少许;碎屑v.捣碎;碎裂
gird	n.嘲笑v.给...佩;束
variant	adj.变化的;不同的n.变体;异读
wisp	n.小把;纸捻;束;缕
tawdry	adj.俗丽而不值钱的n.俗丽而不值钱的服饰
offing	n.近岸锚泊;离岸距离
cerebral	adj.脑的;翘舌音的
shrapnel	n.零钱;榴霰弹;弹片
specify	v.具体指定;明确地讲
adherent	adj.贴生的;粘着的n.信徒
chubby	adj.圆脸的
dislodge	v.把...逐出;强行去除
espouse	v.娶;信奉
itinerant	adj.流动的;巡回的n.流动散工;巡回者
planetary	adj.流浪的;行星的
disparity	n.不同
accrue	v.获得;产生
flagship	n.旗舰;头号
well	adj.对的;井的adv.好;很n.好;井v.涌出;流出
criticize	v.批评;评论
remit	n.提交;委托权限v.缓解;汇
rooster	n.栖息的鸟;雄禽
resonant	adj.共振的;回声的n.共鸣音
waterproof	adj.不透水的
passable	adj.过得去的;可流通的
boom	n.暴涨;吊杆v.使繁荣;暴涨
orifice	n.孔
cooperate	v.合作
accuse	v.指控
conclave	n.集会;秘密会议
impurity	n.不纯;杂质
forearm	n.前臂v.预先武装
ironic	adj.冷嘲的;用反语的
stack	n.大量;排气管v.洗...作弊;形成堆
usurp	v.篡夺;侵犯
knotty	adj.多节的;有结的
monologue	n.独白;独白体诗
trackless	adj.无轨的;无人迹的
mammoth	adj.巨大的n.猛犸;庞然大物
fang	n.尖牙;牙齿
dust	n.地面;粉v.擦去;沾上灰
overseas	adj.海外的adv.在海外
swirl	n.打旋;纷乱v.打旋;回曲
mash	n.糊状物;迷恋v.压碎;挑逗
noontide	n.正午;最高点
fauna	n.动物群;动物志
flurry	n.混乱;阵风v.慌张;微飘
preclude	v.排除;阻止
upbraid	v.责骂
analyse	v.分析;解析
elixir	n.灵丹
chandelier	n.枝形吊灯
evasive	adj.逃避的
gruel	n.稀粥
insincere	adj.不诚恳的
loin	v.腰部
snore	n.打鼾;鼾声v.鼾睡度过;打鼾
rainfall	n.降雨;雨量
squalor	n.肮脏;卑鄙
melodrama	n.传奇剧;音乐戏剧
sprout	n.后裔;新芽v.长出;发芽
retrograde	adj.倒转的;衰退的adv.向后v.衰退;重述
aircraft	n.飞机
cannibal	adj.嗜血成性的n.食人生番
feint	n.佯攻;假装
trimming	n.责骂;整理
gorilla	n.暴徒;大猩猩
ratify	v.正式批准
outlive	v.比...活得长
pump	n.泵;抽运v.用泵抽吸;操作泵
iniquitous	adj.极不公正的
swim	n.漂浮;眩晕v.浸;漂浮
waft	n.吹拂;一阵v.飘荡;轻吹
certify	v.担保;证明
paraphrase	n.释义;演释曲v.将...释义;释义
solidarity	n.团结工会;团结一致
watchword	n.暗语;口令
enliven	v.使快活;使有生气
consulate	n.领事馆;领事任期
scrawl	n.潦草的笔迹v.涂掉;涂写
tasteless	adj.乏味的;无味的
gash	adj.有见识的;多余的n.划开v.砍伤
banjo	n.班卓琴;铲子
rocket	n.火箭;芝麻菜v.惊飞;迅速上升
tractable	adj.驯服的;易处理的
absolve	v.赦免
hinge	n.铰链;枢纽v.使依靠;依...而定
adverb	n.副词;状语词组
dummy	adj.挂名的;假的n.仿制品;人体模型
crypt	n.地窖
italic	adj.斜体的n.斜体
ornate	adj.装饰的
subject	adj.臣服的;需要...的n.题目;学科v.使臣服;提供
inorganic	adj.无机的;无生物的
presage	n.预感;预示v.预感;预示
brawl	n.哗哗声;争吵v.为...争吵;争吵
hussy	n.轻佻女子;针线盒
phonograph	n.留声机
brew	n.酿造过程;酿造量v.酿造;泡
dividend	n.红利;赠品
craze	n.疯狂;时尚v.使发狂;发狂
homicide	n.杀人;杀人者
gild	v.给...镀金;装饰
tuneful	adj.音乐的
consume	v.吃完;毁灭
informer	n.告密者;通知者
obtuse	adj.迟钝的;钝的
skate	n.冰鞋;溜冰v.滑冰
versatile	adj.易变的;多才多艺的
unassuming	adj.不傲慢的
underworld	n.地狱;下层社会
fussy	adj.瞎忙的;易激怒的
locker	n.锁柜;箱
shire	n.郡;夏尔马
hack	adj.陈腐的;受雇的n.砍痕;劈v.耙;劈
garnish	n.服装;装饰菜v.装备;装饰
journeyman	n.雇佣工;子钟
divulge	v.泄漏;宣布
hulk	n.船体;监狱船v.庞然大物般出现
nutriment	n.营养品
sinuous	adj.弯曲的
croak	n.呱呱叫声v.杀害;死
vandal	adj.野蛮的n.野蛮人
auburn	adj.赤褐色的n.赤褐色
satchel	n.书包
wax	n.耳垢;蜡v.变成;变大
apocryphal	adj.次经的
bedlam	adj.疯人院的n.疯子;混乱
forestall	v.垄断;预先阻止
heifer	n.娘们;小母牛
fillet	n.带子;饰线v.把...切成片;用带缚
foregone	adj.已往的
crouch	n.蹲v.低;蹲
vengeful	adj.报复的
drawl	n.慢吞吞拉长调子说出的话v.慢吞吞地说话
alienate	v.使疏远;离间;转让
cramp	n.绞痛;痉挛v.把...关住;痉挛
malign	adj.恶性的;恶意的v.诽谤
salve	n.解救物;软膏v.缓解;说清
exponent	n.阐述者;例子;代表
bewail	v.抱怨;痛哭
generate	v.产生;生
dorsal	adj.背部的;背的n.背部;舌背音
dank	adj.阴湿的
homespun	adj.家里纺的;朴素的n.土布
recumbent	adj.横卧的;躺着的
mop	n.拭子;拖把v.使用拖把;作怪相
putrid	adj.腐烂的
wasp	n.黄蜂
hustle	n.忙碌;推v.催促;难
infinitive	adj.原形的n.原形
thong	n.皮带
bounteous	adj.慷慨的;丰富的
snout	n.口鼻部;口吻状物
suave	adj.温和的;温文的
artificer	n.发明者;技工
dispose	v.安排;排列
morale	n.道德;士气
optimistic	adj.乐观的
reek	n.臭气散发;蒸发v.熏;沾上
wrongful	adj.不道德的;犯法的
nauseous	adj.使人厌恶的
gradation	n.分等;阶段
venal	adj.腐化的;贪赃的
abhorrent	adj.相抵触的;憎恶的
classify	v.把...分类
gorse	n.荆豆;桧
cursory	adj.草草的
ditty	n.小曲
lasso	n.套索v.拉拢
assuage	v.减轻;解...
flute	n.长笛;长形物
dread	adj.可怕的n.担忧;畏惧v.担忧;怕
expiate	v.避免;抵偿
obsession	n.着迷;着魔
goad	n.刺激;赶牛棒v.刺;刺激
ravage	n.大破坏v.使荒芜;毁灭
brusque	adj.粗鲁的
noisome	adj.恶臭的;有害的
reprieve	n.缓刑;暂时解救v.暂时解救
admonish	v.警告;力劝
shorthand	adj.似速记的;速记法的n.速记;速记法
allotment	n.拨款;分配
legitimate	adj.合法的
rational	adj.理性的n.根据
puberty	n.青春期
trice	n.瞬息v.扯起;用绳子拉
tea	n.茶;茶叶
convivial	adj.酒宴的
craggy	adj.陡峭的;毛糙的
moisten	v.弄湿;变湿
violinist	n.小提琴手
atrocity	n.凶恶;残暴
macaroni	n.花花公子;通心面
parochial	adj.受限制的;狭隘的
curriculum	n.课程
emigrate	v.移居外国
janitor	n.门房
rancour	n.深仇
wince	n.退缩;六角盘v.本能地退缩
outdoors	adv.在户外n.户外
splinter	n.裂片v.使分裂;分裂
experiment	n.实验v.进行实验
react	v.使起反应;影响
script	n.笔迹;书写体v.为...写剧本
repine	v.渴望;苦恼
miscreant	adj.信异教的n.恶棍;异教徒
irascible	adj.发怒的;易怒的
pervade	v.走入;遍布
augury	n.预兆;占卜
pelt	n.快速;投击v.下大雨;剥皮
blackmail	n.敲诈v.敲诈;胁迫
pounce	v.突然袭击;猛扑
torrid	adj.热情的;晒热的
pant	n.喷气;气喘v.悸动;气喘
placard	n.布告;小牌v.公告;张贴;安抚
erotic	adj.好色的;性爱的n.好色之徒;色情诗
concussion	n.猛击;震荡
fireman	n.爆破工;司炉工
flinch	n.弗林奇;退缩v.缩;缩脚
seduction	n.教唆;诱惑物
bonus	n.红利;奖金
screech	n.尖叫;烈酒v.尖叫
examine	v.查讯;检查
prate	n.唠叨v.瞎扯;唠叨
tepid	adj.不热烈的;温热的
buxom	adj.丰满的;有健康美的
fetter	n.脚镣v.为...上脚镣
cupola	n.顶塔;穹顶
pointer	n.指示物;指针
asset	n.所有物;资产
evacuate	v.撤离;撤退
opal	n.蛋白石
sedentary	adj.不迁徙的;坐着的
supplant	v.把...排挤掉;取代
corpulent	adj.肥胖的
excise	n.消费税v.向...索高价;切除
palsy	n.颤动;麻痹v.使麻痹
stingy	adj.吝啬的;窄的
pedant	n.男教师;学究
label	n.标签;称号v.把...称为;使示踪
curry	n.咖喱;咖喱菜肴v.打;梳刷
delta	adj.第四位的;四等的n.三角形物;三角洲
digital	adj.手指的;数字的n.琴键;手指
billiard	adj.台球的n.连撞两球所得的分数
quorum	n.法定人数
urn	n.壶;瓮
graduation	n.毕业;刻度
unpack	v.卸下负荷
disengage	v.使脱离;脱离
idealist	n.唯心主义者
mammon	n.贪欲;物质财富
deviate	adj.偏常的n.离差;偏常者v.使背离;背离
inculcate	v.反复灌输;谆谆教诲
colloquial	adj.口语的n.口语;口语体
mouthpiece	n.吹口;代言人
credit	n.信任;信誉v.把...归于;信任
dastardly	adj.卑怯的
inductive	adj.感应的;引入的
ambiguity	n.含糊不清
bitch	n.母狗;怨言v.抱怨;弄坏
confound	v.混淆;使混乱
itch	n.疥疮;痒v.发痒;渴望
fawn	adj.鹿毛色的n.阿谀;幼鹿v.奉承;生
insular	adj.岛民的;孤立的
obsequies	n.葬礼
trans	adj.跨越的
disk	n.花盘;盘
neuter	adj.无性的;中性的n.无性植物;中性v.抵消;阉割
bestial	adj.兽性的;兽欲的
billow	n.巨浪v.翻腾;鼓起
filament	n.长丝;灯丝
weld	n.焊接;焊接点v.焊接;焊牢
covert	adj.掩盖的;隐蔽的n.覆羽;隐蔽
serpentine	adj.狡猾的;蛇的n.蛇纹石
calibre	n.口径;能力
eyelid	n.睑
laconic	adj.简洁的
handicap	n.让步赛;障碍v.妨碍
palette	n.调色板
jolt	n.猛击;震动v.猛敲;震动
demur	n.反对;抗辩v.逗留;抗辩
highlander	n.高地人
stylish	adj.新式的
windlass	n.绞盘v.用绞盘吊起
adamant	adj.坚强的;坚硬的n.坚硬的物质
diagonal	adj.对角线的;斜的n.对角线;斜行
compiler	n.编译程序;汇编者
lugubrious	adj.悲哀的
twang	n.鼻音;弹拨v.弹拨
box	n.箱;巴掌v.打;斗拳
brigadier	n.军士;陆军准将
crucible	n.熔炉;坩埚
spellbound	adj.入迷的
terse	adj.简要的
eyebrow	n.窗头线;眉
nil	adj.没有的n.无
shortage	n.不足;不足乏额
sneeze	n.喷嚏;抓捕v.抓捕;打喷嚏
troupe	n.剧团;一伙v.巡回演出
useful	adj.有用的
beryl	n.绿柱石;浅蓝
cartilage	n.软骨;软骨部分
gape	n.豁口;张口v.张开;豁开
indigent	adj.贫困的;欠缺的
watt	n.瓦
tingle	n.刺痛;震颤v.产生震颤;发丁零声
spurt	n.喷射流v.喷射;急剧上升
stave	n.棍;梯级v.打穿;快走
cross	adj.交叉的;相互的adv.横跨地n.十字架v.穿过;交叉
earshot	n.听力所及的范围
condolence	n.吊唁
dime	n.一角钱;小钱
accord	n.谅解;谐和v.授予;相符合
goblin	n.小妖精
hilarious	adj.引人发笑的
roan	adj.沙毛的n.红白间色;沙毛牲畜
target	n.靶;目标v.规定...的指标
transcript	n.抄本;文字记录;改编曲
giggle	n.傻笑;一群v.咯咯地笑
baptize	v.为...命名;施浸礼
outlaw	n.歹徒v.将...放逐
nebulous	adj.星云的;云雾状的;含混的
beholden	adj.依赖的
winsome	adj.惹人喜爱的
shingle	n.木瓦;小招牌v.使交搭;锻
thankless	adj.不知感恩的
clink	n.钱;押韵v.啪地打;押韵
evasive	adj.逃避的
hygiene	n.卫生
jib	n.艏三角帆;悬臂v.畏缩不前;逡巡不前
scarecrow	n.稻草人
bastion	n.堡垒;棱堡
fungus	n.海绵肿;真菌
taboo	adj.忌讳的n.忌讳;禁忌v.禁止
word	n.词;话v.通知;讲话
holler	n.号子;叫喊v.喊出;叫喊
lathe	n.莱斯;车床v.用车床加工
overall	adj.总的adv.从头到尾;总的说来
jetty	adj.含煤玉的n.防波堤;突出部v.突出
refugee	n.避难人
shuttle	n.梭v.穿梭般来回移动
twinge	n.剧痛;捏v.捏;感到剧痛
interlude	n.插曲;间奏
kinswoman	n.女性家属
protein	n.蛋白质
quinine	n.奎宁
vibrant	adj.震动的;鲜明的;蓬勃的
estuary	n.港湾;入海口
dilate	v.详述;膨胀
dump	n.倾倒;倾销v.倒掉;倾卸
fortuitous	adj.偶然的;幸运的
gaseous	adj.过热的;气态的
lading	n.船货;装载
advocacy	n.辩护;拥护
abed	adj.卧病在床;在床上adv.卧病在床;在床上
mucous	adj.黏液的
tally	n.符木;帐v.数;符合
vaudeville	n.轻歌舞剧;杂耍
smithy	n.铁匠;铁匠铺
film	n.薄层;胶片v.拍摄;拍摄电影
loiter	v.消磨;闲逛
cohesion	n.团结;黏合
cauldron	n.大锅
shipment	n.装运
swamp	n.沼泽v.淹没;下沉
up	prep.往...的上端;往...的上游
housework	n.家务劳动
refectory	n.食堂
gossamer	adj.薄弱的;蛛丝的n.薄纱;蛛丝
skeptical	adj.怀疑的
emolument	n.报酬;利益
evolve	v.释放;演化
intimidate	v.恫吓
refine	v.净化;提炼
untie	v.解开;释放
cos	n.余弦符号
disown	v.否认...是自己的
disprove	v.证明...不能成立
rut	n.常规;车辙v.动情
mausoleum	n.陵墓
misuse	n.错用;恶行v.错用;虐待
sentient	adj.意识到的
unscathed	adj.没有负伤的
vomit	n.呕吐;喷出v.呕;喷
actuality	n.记录片;真事
analytical	adj.分析的
disclaim	v.放弃;否认
demise	n.传位;死亡v.传;死
gene	n.基因
silhouette	n.轮廓v.画黑色轮廓像
quizzical	adj.探询的;戏弄的
elicit	v.引出;引起
proxy	adj.代理的n.代理权;代理人
crochet	n.钩针编织v.用钩针编织
crackle	n.异彩;噼啪声v.使爆裂;闪烁
definitive	adj.决定性的;限定的
delinquent	adj.失职的;有过失的n.罪犯
facsimile	n.电传真;摹本
initiate	n.新入会的人v.接纳;开始
merge	v.合并;结合
affluent	adj.畅流的;充裕的n.富裕的人;支流
furlough	n.休假;休假证v.解雇;休假
maw	n.胃;咽喉
venial	adj.可饶恕的;可原谅的
reversal	n.撤销;反向
squander	n.浪费v.浪费;浪荡
felicitous	adj.恰当的
handcuff	n.镣铐;手铐v.束缚...的手脚
resist	v.抵抗;抗
debility	n.体弱
origin	n.出身;起端
buttonhole	n.钮孔v.锁
milliner	n.女帽设计者;妇女头饰
nape	n.项;后颈
titan	n.大力士
wile	n.诡计;狡猾v.消磨;引诱
wither	v.使干枯;干枯
decoy	n.假鸟v.引诱;诱骗
nanny	n.保姆
coyote	n.丛林狼;人形精怪
wrangle	n.吵架v.说服;争得
encamp	v.扎营
mallet	n.大头锤;木槌
shatter	v.破坏;削弱
negligible	adj.极小的
magnesia	n.氧化镁
granary	n.谷仓;主要来源
aver	v.断言;证明...属实
underfoot	adv.碍事地;在脚下
brat	n.顽童;围裙
thimble	n.顶针;套筒
downtown	adj.商业区的n.较低地区;商业区
heron	n.鹭
carp	n.牢骚v.找茬儿
jog	n.暗示;慢跑v.触动;轻摇
inhale	n.吸入;吸烟v.吃;吸入
rectify	v.调正;精馏
sociology	n.社会学
sort	n.性质;种类v.拣出;符合
tit	n.打击;按钮
defunct	adj.已死的
tow	n.拖;绳v.拖;拖行
pulley	n.滑轮
rump	n.牛臀肉;臀部
mail	n.邮件;邮政v.邮寄;寄出
skinny	adj.不足的;皮的;皮包骨的
squash	adv.挤压地n.挤压;硬挤v.粉碎;硬放
absorb	v.把...并入;吸收
derrick	n.神偷;钻塔;起重机
octave	n.八度;八度音栓
voter	n.投票人
teens	n.十三至十九数字;十几岁
voracious	adj.贪吃的
cad	n.小市民
federation	n.结成同盟;同盟
pus	n.脓
unbend	v.卸除;变直;变松弛
monsoon	n.季风
sparse	adj.很小的;稀薄的
trumpery	adj.花哨而无价值的n.废话;零星杂物
tighten	v.使变紧;变紧
aspen	adj.颤动的;山杨的n.山杨
scoop	n.匙杓;勺v.挖成;舀
spongy	adj.多孔的;海绵的
alibi	n.借口v.为...辩解;辩解
unload	v.摆脱;倾诉
chirp	n.嘎吱声;啁啾声v.啁啾
snipe	n.狙击;沙锥v.狙击;打鹬
almanac	n.历书;年鉴
dignitary	adj.显贵的n.显贵
habitat	n.生境;住处
regional	adj.地区的;区的
pasty	adj.苍白的;浆糊的n.馅饼
squint	adj.斜的;斜视的n.眯眼;斜视v.眯起;使斜视
navigate	v.驾驶;航行
scrawl	n.潦草的笔迹v.涂掉;涂写
cornet	n.短号;音栓
uphill	adj.艰难的;上升的adv.艰难地;往上坡n.上坡
clamber	n.爬v.爬;攀缘
portent	n.迹象;奇才
stow	v.储藏;剪
backwoods	n.边远蛮荒林区
evoke	v.唤起;使再现
exigency	n.急事;紧急
groundwork	n.垫上运动;基础
sinew	n.肌腱;力量v.给...以力量;使牢固
stepfather	n.继父
buffet	n.打击;抖振;自助餐v.打;打击
scenic	adj.舞台的;戏剧的
arrant	adj.彻底的
dilute	adj.减弱了的;褪了的v.稀释;削弱
nurture	n.养育;营养物v.给...营养物;养育
tripod	n.三脚凳;三脚架
glum	adj.死气沉沉的
goodbye	n.告别
partake	v.参与;吃
potter	n.陶工v.闲混;闲逛
dragoon	n.骑马步兵;食用家鸽v.镇压
blister	n.水疱;疱病v.猛烈抨击;起水疱
mote	n.尘埃;疵点
tornado	n.龙卷风;旋风
agrarian	adj.土地的;土地所有制的n.平均地权论者
demolish	v.拆毁;吃完
harrow	n.耙v.耙;弄伤
inversion	n.倒装;反向
embargo	n.封港令;禁止v.征用
pervert	n.背教者v.歪曲;误用
closet	n.橱;退避处v.把...引进密室会谈
fiftieth	n.第五十
cyclone	n.气旋;旋风器
dawn	n.开端;黎明v.开始;破晓
saliva	n.气泡条;涎;唾液
cube	adj.三次幂的n.立方;鱼藤v.量...的体积
saw	n.锯;锯床v.锯;锯成
syntax	n.句法
frost	n.冰冻;霜v.结霜于;结霜
playwright	n.剧作家
detract	v.减损;转移
truculent	adj.粗暴的;好战的
downpour	n.大量照射;倾盆大雨
locust	n.蝉;蝗虫
abandon	n.放任;狂放v.放弃;离弃
annul	v.废除;使消失
dimple	n.酒窝;涟漪v.使现笑靥;现笑靥
finesse	n.飞牌;手腕;技巧v.用...飞;飞牌
glean	v.查明;拾
incendiary	adj.放火的;能燃烧的n.放火者;燃烧弹
hash	n.改头换面v.把...搞糟;把...切碎
horseshoe	n.马蹄铁v.给...钉掌
liner	n.定期船;衬里
writhe	n.扭动;盘绕v.扭动;扭曲
carrot	n.胡萝卜
regimen	n.情势
slam	n.猛关;满贯v.使劲关;闯
tactical	adj.有策略的;战术的
graceless	adj.不优美的;堕落的
narcotic	adj.催眠的;麻醉的n.麻醉剂
bowl	n.碗;木球v.得...分
adage	n.谚语
overt	adj.公开的;明显的
relevant	adj.相关联的;有关的
memento	n.回忆;纪念物
concentric	n.同心圆
melon	n.瓜;深粉红色
munificent	adj.丰厚的;慷慨的
accent	n.口音;重音;腔调v.着重
peanut	adj.渺小的n.花生;花生米
flog	v.鞭打;驱使
humdrum	adj.平凡的n.乏味的话;平凡
out	adv.出;呸prep.从...里面;从...中出来
escapade	n.脱逃;越轨行为
parsimony	n.极度节俭;俭省
ferment	n.发酵;激动v.酝酿;发酵
functional	adj.官能的;职务上的
coffer	n.金库;箱子
gill	n.菌褶;鳃v.用刺网捕
entangle	v.缠住;弄乱
demagogue	n.民众领袖
combat	n.战斗v.与...战斗;战斗
domicile	n.原籍;住处v.使定居;居住
eastward	adj.向东的adv.向东n.朝东的方向
crater	n.环形山;坑;火山口
iceberg	n.冰山
leak	n.漏;漏洞v.使渗漏;漏
agate	n.玛瑙
construe	v.解释;推断
craftsman	n.工匠
precursor	n.先驱
teller	n.出纳员;计票人
displace	v.取代...的位置
humiliate	v.使蒙耻
harpoon	n.鱼叉v.用鱼叉叉
mitre	n.主教冠;斜接面v.给加冠;斜接
tattoo	n.纹身;归营号v.刺
tram	n.煤车;纬纱v.用煤车运
whack	n.失灵;重击v.击败;砍
resultant	adj.组合的n.合量;结果
autonomy	n.人身自由;自治
opus	n.作品;作品编号
textile	n.纺织品;纺织业
blubber	n.鲸脂;赘肉v.哭诉;哭肿
accountant	n.会计人员
affray	n.闹事v.恐吓
indelicate	adj.不文雅的
fetid	adj.恶臭的
forthright	adj.直率的adv.立即;直率地n.直路
stink	n.恶臭;化学v.发出恶臭;惹人讨厌
cucumber	n.黄瓜;一块钱
platoon	n.排;一队
dishearten	v.使沮丧
paragon	n.杰出典范v.把...作比较;胜过
swirl	n.打旋;纷乱v.打旋;回曲
baton	n.短棍;官杖
ewe	n.母羊
chafe	n.擦;磨损v.擦热;擦伤
retort	n.反驳;反击v.驳回;反驳
duck	n.鸭;野鸭v.躲避;忽地低下
frontal	adj.额的;前面的n.额骨;正面
topography	n.地形;地志
cold	adj.感觉冷的;冷的adv.突然地;完全地n.感冒;冷
prop	n.支柱;道具v.支撑;架
bison	n.野牛
fiat	n.决断;命令
vellum	adj.犊皮纸的n.仿犊皮纸;手稿
ascension	n.上升;耶稣升天
bluster	n.狂吹v.夸口;狂吹
orgy	n.纵欲;狂欢会
auditory	adj.听的
graph	n.图;图像v.绘...的图;描绘
solvent	adj.有溶解力的n.解决办法;溶剂
loophole	n.观察孔;漏洞v.在...上开枪眼
fascinate	v.有吸引力
nomadic	adj.流浪的;游牧的
will	aux.将;能n.决心;意愿
mash	n.糊状物;迷恋v.压碎;挑逗
sortie	n.出击;出击部队v.出击
impel	v.激励;推动
cute	adj.漂亮的
piecemeal	adj.逐个的adv.成碎片地
clod	n.块;泥土
scorpion	n.拟蝎;蝎
tattoo	n.纹身;归营号v.刺
diploma	n.公文;执照
stiffen	v.使变硬;变硬
ticklish	adj.敏感的;怕痒的;棘手的
vaunt	n.夸耀;自吹自擂v.吹嘘
rick	n.草堆;柴垛v.把...堆成垛
smear	n.涂片;污迹v.诽谤;弄脏
woodpecker	n.啄木鸟
bay	adj.枣红色的n.湾;坝v.对...吠叫;大声叫嚷
exactitude	n.严格;正确
lunacy	n.精神错乱;心神丧失
strut	n.高视阔步;支柱v.炫耀;膨胀
waive	v.放弃;推迟考虑
scuttle	n.车颈;箩v.逃避;放弃;凿沉
double	adj.两倍的;双的adv.两倍地;双双地n.酷似的人;两倍v.握紧;代替
literacy	n.识字;熟谙文学
parry	n.挡开;闪避v.挡开;回避
waitress	n.女侍者
concubine	n.妾;姘妇
fume	n.烟v.发出;熏
certitude	n.确信;准确性
dynamo	n.发电机
espionage	n.间谍行为
spout	n.喷口;水柱v.把...当掉;喷出
tedium	n.单调乏味
clog	n.脚坠;木屐v.塞满;阻碍
envelop	v.包围;包住
primer	n.入门书;雷管
luminary	adj.光的n.发光体;发光天体
chamois	n.羚羊皮;岩羚羊
spree	n.狂饮作乐;嬉戏
synthetic	adj.合成的;假想的n.合成物
weasel	n.告密者;鼬v.告密;狡辩
damp	adj.潮湿的;迷乱的n.潮湿;矿井瓦斯v.封;阻尼
trainer	n.教练机;教员
magpie	n.鹊
brew	n.酿造过程;酿造量v.酿造;泡
conserve	n.蜜饯;药物糖果v.保护;使守恒
keynote	n.要旨;主音v.给...定基调;给...定音
garbage	n.废话;垃圾
photo	adj.照片的n.照片v.为...拍照
gazelle	n.瞪羚
gory	adj.血块似的;充满暴力的
holocaust	n.大破坏;大屠杀
lag	n.间歇;落后v.减弱;滞后
beckon	n.点头v.吸引;示意
guy	n.支索;家伙v.嘲笑;乱演
autocrat	n.独裁者
buffoon	n.滑稽的人;丑角
dysentery	n.腹泻;痢疾
rat	n.耗子;鼠v.偷;捕鼠
acumen	n.渐尖头;敏锐;明智
churlish	adj.粗暴的;吝啬的
nothing	pron.没有东西
eradicate	v.根除;连根拔起
suffix	n.后缀;下标v.加...作后缀
textbook	n.教科书
contumely	n.傲慢;侮辱行为
spoonful	n.一匙的量
nostril	n.鼻孔;鼻孔内壁
deride	v.嘲笑
aqueduct	n.导管;沟渠
derogatory	adj.贬低的;贬义的
fatuous	adj.痴呆的;虚幻的;昏庸的
flinch	n.弗林奇;退缩v.缩;缩脚
gymnastics	n.技巧;体操
hectic	adj.潮红的;发红的
subscriber	n.订阅者;签署的
causal	adj.原因的
eerie	adj.怪异的;恐惧的
gripe	n.抱怨;肠绞痛v.惹烦;抱怨
onerous	adj.沉重的;有偿的
fen	n.沼;分
limp	adj.软的;软面的n.跛行v.格律不顺
throttle	n.喉咙;节流阀v.卡;使节流
wold	n.丘陵地带;山丘
bevy	n.一队;一批
fake	adj.假的n.假货;骗子v.伪造;伪装
obloquy	n.丑名;指责
prism	n.棱柱;三棱镜
prig	n.纨绔子弟;扒手
verbatim	adj.一字不差的adv.一字不差地
equatorial	adj.赤道的n.赤道仪
sonata	n.器乐曲;奏鸣曲
toothless	adj.无强制实施手段的
stucco	n.粉饰灰泥;拉毛粉饰v.用拉毛粉饰法粉饰
bust	n.前胸;胸像v.爆裂;破产
glisten	n.闪光v.闪闪发光
pout	n.撅嘴;生气v.撅起;撅嘴
breech	n.炮尾;臀部v.给装上后膛
depreciate	v.贬低;降价
cavil	n.吹毛求疵的意见v.对...挑剔;挑剔
dialectic	n.辩证;辩证逻辑
flighty	adj.轻浮的
capsule	adj.概要的;微小的n.胶囊;小盒;太空舱
constrain	v.强迫;限制
economist	n.管理人;经济学家
dunce	n.笨蛋;书呆子
niggardly	adj.很小的;小气的adv.小气地
finale	n.结尾;终场
jocular	adj.诙谐的
whimper	v.抽搭;发呜咽声;啜泣
skunk	n.卑鄙的人;臭鼬v.不付...的帐;彻底击败
umbrage	n.生气;叶丛
autocracy	n.独裁统治
belie	v.辜负;掩饰
comma	n.逗号;停顿
palatial	adj.宫殿的
saline	adj.盐的n.碱盐泻药;盐泉
swindle	n.冒名者;诈骗行为v.诈骗;诈取
aspirant	adj.渴望的n.有抱负的人
athletic	adj.健壮的;体育的
fatten	v.育肥;长肥
abnormal	adj.变态的;反常的
blacken	v.破坏;变黑
miser	n.吝啬鬼;守财奴
tack	n.系;东西v.连接;改弦易辙
wriggle	n.扭动v.扭动;摆脱
blare	n.大吹大擂;嘟嘟声v.耀眼地发;发嘟嘟声
hoot	adv.啐n.大叫;报酬v.喊叫;鸣叫
sicken	v.枯萎;生病
mow	n.干草堆;鬼脸v.刈;刈草
iodine	n.碘;碘酊
skill	n.技术;熟练性
unctuous	adj.奉承人的;油的
depose	v.罢免;证实
legation	n.代表团
squeal	n.抱怨;火腿v.抱怨;告密
tulip	n.郁金香
asphalt	n.沥青;天然沥青v.铺沥青于
infect	v.传染;污染
aggressor	n.侵略者
incisive	adj.锋利的;讥刺的
premise	n.假定;上述各点v.引出;预先提出
stunt	n.矮株病;发育不良v.阻止
assorted	adj.分类的;相配的
bumper	n.满杯;反弹球adj.丰富的
downhill	adj.不难的;下山的adv.向山下n.下坡路;下山
gage	n.抵押品;梅子v.以...作担保
loop	n.环路;圈v.把...打成环;打环
elocution	n.演讲技巧
defraud	v.骗取;进行诈骗
beaver	n.海狸毛皮;河狐v.努力工作
affidavit	n.宣誓书
apropos	adj.恰当的adv.附带地;恰当地prep.关于
bolster	n.长枕;垫子v.支撑;支持
pod	n.承窝;荚v.生荚果;聚成群
adverb	n.副词;状语词组
saunter	n.闲逛v.闲逛
demented	adj.疯狂的
vicarious	adj.代理的;间接的
chattel	n.动产;奴隶
consign	v.留出;运送
designer	n.谋划者;设计者
first	adj.第一的;基本的adv.宁可;先
rivet	n.铆钉v.铆
congregate	v.使集合;集合
protege	n.被保护人
laundress	n.洗烫衣物的女工
chick	n.小孩;小鸡
colic	adj.绞病的;结肠的n.绞病
holster	n.手枪皮套
paraffin	n.煤油;石蜡v.涂石蜡于
secrete	v.分泌;隐藏
dune	n.沙丘
enigmatic	adj.谜的
quiescent	adj.静息的;静止的
bowl	n.碗;木球v.得...分
donor	n.供血者;赠送人
manganese	n.锰
leaky	adj.爱哭的;漏的
embellish	v.美化;装饰起来
spinach	n.菠菜;菠菜叶
chlorine	n.氯
tarpaulin	n.水手;油布帽
damper	n.挡板;制音器
intensive	adj.集约的;加强的n.加强器;强调成分
operative	adj.操作的;有效的n.技工;侦探
patronize	v.惠顾;资助
racy	adj.辛辣的
tankard	n.大酒杯
uproarious	adj.骚动的
whitewash	n.粉饰;石灰水v.使得零分
oddity	n.怪人;奇特
assay	n.试金;试样v.化验;试验
hanker	v.渴望
chaplet	n.串珠;花冠
tirade	n.专题描述
synonym	n.换喻词;同义词
visor	n.面甲;遮阳
waif	n.流浪儿;无主失物
cogent	adj.有说服力的
absolutism	n.绝对性;绝对主义
apprise	v.通知
blindfold	adj.鲁莽的adv.鲁莽地;盲目地n.蒙眼的布;障眼物v.蒙住...的眼;使不理解
dote	v.腐朽;溺爱
iron	n.铁;熨斗v.熨;熨衣
croquet	n.贴击;槌球游戏v.贴击
debut	n.首次进入社交界v.首次演出
keyboard	n.键盘;钥匙板
marmalade	n.橘子酱
poniard	n.短剑v.用短剑刺死
trenchant	adj.锐利的;鲜明的
rabid	adj.狂暴的;狂热的
totter	n.收旧货的人v.摇晃;蹒跚
radiate	adj.有辐射的v.发射;流露
shotgun	adj.被迫做的;猎枪的n.猎枪;媒人
dutiful	adj.尽职的;职责的
encircle	v.环绕;绕行
pliable	adj.易适应的;易弯的
telegraphy	n.电报学
thousandth	n.第一千;千分之一
indoor	adj.室内的
revoke	n.藏牌v.撤回;藏牌
rust	adj.铁锈色的n.铁锈色;锈v.发锈;生锈
whiten	v.使白;变白
drizzle	n.毛毛雨;涓涓细流v.洒湿;洒落
fop	n.纨绔子弟v.欺骗
emancipate	v.解放
jig	n.黑人;玩笑v.轻快地跳;跳汰选
parlance	n.说法;谈话
derelict	adj.荒废的n.乞丐
diver	n.潜鸟;潜水艇;蛙人
hydraulic	adj.水力的;水压的
mesh	n.网;网孔v.使缠住;相啮合
elite	adj.杰出的n.上层人士
hearth	n.壁炉边;炉缸
seamanship	n.航海技能
weakling	adj.瘦弱的n.瘦弱的人
bygone	adj.过去的
liaison	n.联络;联系
putty	n.铁油灰;腻子v.用油灰填塞
ribald	adj.下流的n.开下流玩笑的人
amplitude	n.充足;幅度
yen	n.日元;渴望
dimension	n.尺寸;范围v.在...上标出尺寸
infest	v.遍布于;寄生于
usurer	n.放债人;高利贷者
congenital	adj.十足的;天生的
cram	n.极度拥挤;死记硬背v.把...塞进;把...塞满
roseate	adj.光明的;乐观的
concurrent	adj.合作的;同意的
dilatory	adj.迟误的;拖延的
plaudit	n.喝彩
smock	n.罩衣v.给...穿罩衣
immobile	adj.不活动的;不在动的
slush	n.烂泥v.给...灌砂浆;溅泼
harbour	n.避风港;港v.庇护;心怀
abjure	v.避免;发誓弃绝
encroach	v.侵占
flagon	n.酒壶
ulcer	n.腐烂物;溃疡
admissible	adj.可进入的;可容许的
combatant	adj.好斗的n.格斗者
dyspepsia	n.消化不良
gnat	n.琐事;蚊子
pied	adj.杂色的
vodka	n.伏特加
catalogue	n.目录;一系列v.登记;编目录
joint	adj.共有的;接合的n.关节;接合
nibble	n.啃;少量食物v.啃
dab	n.轻击;轻拍v.轻敷;轻击
derisive	adj.嘲笑的;可笑的
inception	n.开始
jerky	adj.不平稳的;多突变的n.肉干
cleavage	n.裂缝;劈开
yacht	n.冰上滑艇;快艇v.驾快艇
disparage	v.贬低;诋毁
pave	adj.密镶的v.铺;铺满
transcend	v.超出;胜过
caper	n.蹦跳;活动v.跳跳蹦蹦
tick	n.虱蝇;蜱v.给...标记号;活动
object	n.对象;物体v.提出;反对
greenery	n.绿色植物;温室
ail	v.使受病痛;处境困难
breaker	n.破碎者;碎浪
deflect	v.转移;偏斜
gut	adj.极其重要的n.肚子;内脏v.抢劫
incision	n.切口;切入
poster	n.招贴;驿马
accelerate	v.促进;加快
churn	n.搅乳器;桶v.过度买卖;剧烈搅动
intensify	v.加厚;加强
monotone	adj.单调的n.单调;单音调
wean	v.使断奶;使放弃
abortion	n.流产;堕胎
sweater	n.发汗剂;针织套衫
kith	n.朋友
notation	n.记法;注释
tubular	adj.管的
typical	adj.典型的;特有的
abstain	v.戒绝;弃权
hymen	n.处女膜
bounce	n.吹牛;弹回v.反射;跳
dwindle	v.使缩小;衰落
absence	n.缺乏;缺席
penguin	n.企鹅
aqueous	adj.水成的;水的
mermaid	n.美人鱼
vampire	n.吸血鬼
commitment	n.交押;托付;诺言
blaspheme	v.诽谤;亵渎
glutton	n.贪吃的人;狼獾
militarism	n.军国主义;尚武精神
coastal	adj.海岸的
lap	n.耳垂;舐v.嵌接;舔
liturgy	n.礼拜仪式;圣餐仪式
romp	n.嬉耍喧闹v.轻快地跑
surfeit	n.恶心;过量v.饮食过度
queue	n.辫子;排队v.使排队;排队
ashy	adj.灰色的;像灰的
oblation	n.供物
bravo	n.喝彩声;打手v.向...喝彩
communism	n.共产主义
lascivious	adj.好色的
ovum	n.卵;卵形饰
armature	n.电枢;盔甲
padlock	n.挂锁;关闭v.正式关闭
plantain	n.车前;大蕉
shambles	n.混乱;屠宰场
feline	n.猫科动物adj.猫科动物的
salvage	n.海上打捞;海上救助v.打捞;抢救
trespass	n.打扰;冒犯v.逾越;打扰
bracket	n.牛腿;托架v.把...围住;给...装托架
jocund	adj.欢乐的
peep	n.初现;窥孔v.窥;隐现
elucidate	v.阐明;提供说明
glut	n.暴食;大量v.充斥;阻塞
yelp	n.尖声急叫v.叫喊着说;尖声急叫
epilogue	n.结尾部分;收场白
livestock	n.家畜
cork	n.瓶塞;栓皮v.给...装软木;克制
requital	n.报偿;报偿物
spa	n.矿泉;游览胜地
fertilizer	n.肥料
totality	n.全食;全体
domino	n.西洋骨牌
elegy	n.挽歌
inverse	adj.反的;相反的n.相反
deprecate	v.贬低
magnate	n.要人
unlettered	adj.无字的
accost	n.搭讪v.勾搭
evaporate	v.消失;蒸发
palliate	v.减轻;掩饰
storey	n.楼层
exasperate	adj.被激怒的;糙面的v.激怒;使加剧
tether	n.缰绳;限度v.拴;限制
aviation	n.航空;航空学
collusion	n.共谋
redundant	adj.过多的;累赘的
hygienic	adj.卫生的;卫生学的
cache	n.秘窖;贮藏处v.秘藏起来
erudite	adj.博学的
extirpate	v.灭绝;摘除
freehold	adj.可终身保有的n.终身职位
orchestral	adj.管弦乐队演奏的
prank	n.胡闹v.胡闹;打扮
libel	n.诽谤;原告诉状v.诬蔑
migratory	adj.流浪的;迁移的
compute	v.计算
ethnic	adj.异教徒的;种族的
handicraft	n.手工业;手艺
scorch	n.烧焦;灼伤v.挖苦;切
anthology	n.选集
gastric	adj.胃部的;胃的
admiralty	n.海事法庭
collegiate	adj.大学的;社团的
nonce	adj.特定场合的n.特定场合;强奸犯
pare	v.修掉;修剪
tress	n.头发;枝条
epilepsy	n.癫痫
linear	adj.线的;线构的
maltreat	v.误用;虐待
tot	n.小孩;合计v.合计
slur	n.蹭污;污点v.对...疏忽;被蹭污
retaliate	v.报复
shear	n.剪v.剪;修剪
corolla	n.花冠
broach	n.凿子;炙叉;提出v.开始提及;钻孔开启
bleach	n.漂白;漂白度v.晒白;消除
compress	n.打包机;敷布v.压紧;镇压
dapper	adj.衣冠楚楚的
marital	adj.夫妻的;婚姻的
pertain	v.从属;适合
slash	n.鞭打;砍;叉口v.鞭打;砍
snowstorm	n.雪暴;掼奶油
blot	n.墨水渍;污点v.弄脏;污损
gad	adv.哎哟n.游荡;钢钎v.蔓延;游荡
optimist	n.乐观者
repository	adj.长效的n.仓库;店铺
seedy	adj.结籽的;破旧的
erosion	n.腐蚀;糜烂
devolve	v.被移交;转让
plantain	n.车前;大蕉
keg	n.桶钉;小桶
main	adj.辽阔的;完全的n.体力;叫数
serenade	n.小夜曲v.唱小夜曲
trellis	n.格子架v.给...搭棚架
cumbersome	adj.笨重的;累赘的
espy	v.看出;窥见
movie	n.电影;电影业
alpha	adj.第一位的n.第一个;优等
condense	v.聚集;冷凝
outermost	adj.最外面的
smoker	n.吸烟室;吸烟者
tenacious	adj.坚韧的;强的
tricky	adj.难以捉摸的
aggressive	adj.侵犯的
esoteric	adj.秘传的
pineapple	n.凤梨;手榴弹
tigress	n.雌老虎;母虎
navel	n.脐;中心
tempo	n.节奏;速度
vaunt	n.夸耀;自吹自擂v.吹嘘
immune	adj.免除的;免疫的n.免疫者
winnings	n.赌赢的钱
bilateral	adj.两边的;双方的
corduroy	n.灯芯绒;木排路
woodman	n.伐木人;护林官
irate	adj.发怒的
vapid	adj.乏味的;无趣乏味
compost	n.堆肥;混合物v.施堆肥于
enact	v.颁布;扮演
pest	n.瘟疫;有害生物
trousseau	n.包袱;嫁妆
cocktail	adj.鸡尾酒会的n.合成物;鸡尾酒
globular	adj.球形的;全球的
revert	v.回复;重提
wallow	n.打滚;堕落v.打滚;颠簸
amidships	adv.在中部
recorder	n.记录者;记录装置
twitter	n.吱吱叫;嘲弄者v.颤动;嘲笑
venereal	adj.性爱的
bated	adj.变弱的
jug	n.大罐;监狱v.煮;鸣叫
polo	n.马球
cobweb	n.陷阱;蜘蛛网
dike	n.漂亮打扮;水坝;排水沟v.把...打扮得漂漂亮亮
#drier	n.干燥工;干燥器dry的比较级
hunch	n.厚片;肉峰;直觉v.使弓起;移
apostrophe	n.撇号
clarity	n.清澈;清晰
affix	n.词缀;贴上;附加v.添;添上
babyhood	n.婴儿期
mauve	adj.淡紫色的n.淡紫色;木槿紫
panacea	n.治百病的灵药
pithy	adj.衬皮厚的;髓的
tumultuous	adj.吵闹的;狂暴的
beautify	v.使美起来;变得美
lanky	adj.过分瘦长的
subversive	adj.颠覆性的
grandiose	adj.宏伟的
millinery	n.女帽
molecule	n.分子;些微
disrepute	n.丧失名誉
chary	adj.节约的;谨慎的
imitator	n.模仿者
pincers	n.钳子;螯
choleric	adj.霍乱的;激怒的
foray	n.初步尝试;突袭v.进行突袭
foundry	n.铸件;铸造
dugout	n.独木舟
agitator	n.鼓动者;搅拌器
bum	adj.假的;劣质的n.差劲者;屁股v.乞求;寄食
whooping	adj.极大的
cop	n.抓;顶v.攫;偷
paternity	n.父亲身份;来源
stentorian	adj.极洪亮的
influenza	n.流行性感冒
recondite	adj.玄妙的
bramble	n.黑莓;黑莓果
corollary	adj.具有推断性质的n.推断;系
dirk	n.短剑v.用短剑刺
emanate	v.发出;发源
offhand	adj.不友好的;随便的adv.不假思索地
garish	adj.俗丽的
orient	n.东;东方v.给...定向;适应
abdicate	v.正式放弃;退出
debonair	adj.温厚的;温雅的
skein	n.一绞;一群v.把...绕成绞
gratuity	n.退伍金;小费
pedagogue	n.教师
snob	n.势利的人;鞋匠
outdo	v.战胜
sperm	n.精液;精子
tanker	n.槽车;罐车
clam	n.蛤;抓斗v.挖蛤
conduit	n.导线管;渠道
idiom	n.方言;习语
scullery	n.洗涤室
climatic	adj.气候的
selfish	adj.自私的
brazier	n.火盆;铜匠
cashmere	n.开士米
squabble	n.争吵v.弄乱;争吵
bolt	n.插销;螺栓v.闩;筛
bray	n.驴叫声v.叫;打
glib	adj.能说会道的
rant	n.大话;狂欢;咆哮v.大声责骂;痛饮
scamper	n.快跑v.奔跑;匆忙游览
citron	n.香橼色;枸橼
inane	adj.空的;空洞的n.空洞之物;空间
virtuoso	n.艺术大师
curb	n.控制;路缘v.控制;勒住
hoard	n.宝窟;临时围篱v.贮藏;积聚钱财
simplify	v.简化;变简单
whet	v.刺激;磨
infringe	v.违反;侵犯
endorse	v.背书;签署;认可
petal	n.花瓣
remiss	adj.玩忽的
abridge	v.减少;缩短;删节
punt	n.踢悬空球;一分v.踢;赌博
wordy	adj.话多的;言语的
bestir	v.使发奋
flounder	n.挣扎;鲆v.犯错误;挣扎
hair	n.毛;头发
dent	n.打;齿v.使凹陷;削减
focus	n.焦点;焦距v.集中;聚焦
dope	n.消息;药v.给服药;吸毒
acclaim	n.欢呼v.宣布;欢呼
gloat	n.心满意足v.爱慕地看
pessimist	n.悲观者
lunge	n.冲;调教索v.用刺
scurrilous	adj.用污言秽语谩骂的
womanish	adj.妇女的;女子气的
canvass	v.检查;细阅;游说
engross	v.正式写成
isolate	v.使隔离;隔离
rut	n.常规;车辙v.动情
vault	n.洞穴;拱顶v.成穹状;跳跃
coast	n.海岸;滑行v.绕...而行;滑行
flue	n.唇管;滑槽
kennel	n.狗窝;沟渠v.为...提供住处
truss	n.捆;构架v.扎
subvert	v.颠覆;搅乱
captivate	v.使入迷;抓住
unofficial	adj.非官方的
acme	n.最高点
fluster	n.慌乱v.使慌张;使醉
impeach	n.控告v.弹劾;控告
injection	n.充血;注射
canny	adj.节约的;精明的adv.十分
palaver	n.废话;奉承v.奉承;交涉
hive	n.蜂群;蜂箱v.贮存;隐居
flout	n.嘲笑v.藐视
label	n.标签;称号v.把...称为;使示踪
longevity	n.长寿;寿命
coerce	v.强制;抑制
network	n.网状物;织物v.用网覆盖
cinder	n.熔渣;炭渣
lame	adj.金银锦缎;跛的n.老古板;薄板v.使跛;变跛
artificer	n.发明者;技工
scribble	n.拙劣的作品v.乱涂;粗梳
shin	n.胫;胫骨v.攀;快步走
elliptical	adj.省略的;椭圆的
emolument	n.报酬;利益
sandal	n.凉鞋;浅帮鞋
sock	n.短袜;套子v.储;打
besotted	adj.痴迷的
gangrene	n.道德败坏;坏疽v.生坏疽
tenable	adj.可担任的;能防守的
dalliance	n.调戏;闲混
excitation	n.刺激;激感
incursion	n.进入;侵入
television	n.电视;电视机
daunt	v.使胆怯;威吓
huddle	n.混乱v.挤作一团
liqueur	n.利口酒
clinch	n.钳住对手;确定v.确定;拥抱
cereal	adj.谷物的n.谷类植物;谷物
captious	adj.糊弄人的
container	n.容量;容器
movie	n.电影;电影业
pointer	n.指示物;指针
secretive	adj.分泌的
dig	n.触;挖苦v.掘得;挖成
fortieth	n.第四十
glaze	n.糖浆;釉v.给...上釉;凝视
lee	n.庇护所;庇荫
malefactor	n.罪犯
variant	adj.变化的;不同的n.变体;异读
zoology	n.动物区系;动物学
weedy	adj.杂草的
lint	n.棉绒;皮棉
pact	n.契约
shifty	adj.变动的;机智的
unprovoked	adj.未受挑衅的
aura	n.光环;气氛
fatalism	n.宿命论
heartache	n.痛心
emporium	n.大百货店;大场所
larceny	n.盗窃
convince	v.使确信;使知错
charlatan	adj.庸医的n.庸医
migrate	v.迁徙;移居
snap	adj.迅速的;摁扣的n.厉声;劈啪声v.发吧嗒声;喀嚓折断
contralto	adj.女低音n.女低音
hobble	n.束缚物;跛行v.束缚;跛行
cosmos	n.宇宙;秩序
hyena	n.袋狼;鬣狗
asthma	n.气喘
catacomb	n.地下墓地;地下走道
granny	n.保姆;奶奶
pollute	v.污染;玷污
zoological	adj.动物的;动物学的
effete	adj.过时的;衰老的
engender	v.生育;发生
uncut	adj.未雕琢的;未切的
overload	n.超载v.使超载;装填...过满
trinket	n.小装饰物v.秘密策划
forefront	n.最前线
gregarious	adj.合群的;群的
gunshot	n.枪弹;射程
reinstate	v.使恢复原职
cede	v.割让;转让
component	adj.组成的n.成分;分力
innocuous	adj.无害的
mercurial	adj.活泼的;雄辩的n.汞制剂
citation	n.表彰;引用
hedgehog	n.刺猬;菱形拒马
buckwheat	n.荞麦;荞麦片
diverge	v.分叉;离题
phonetic	adj.语音的
tanner	n.鞣皮工;鞣皮工;六便便士硬币
blackboard	n.黑板
breakwater	n.防波堤
lymph	n.浆;淋巴
bogus	adj.假的
circumvent	v.环绕;绕过
snowball	n.雪球v.向...扔雪球;扔雪球
electorate	n.选举人
erase	v.擦掉;消除
mediate	adj.间接的;居间的v.转交;调解
augur	n.预言者;占卜官v.预示;预言
booby	n.笨蛋;鲣鸟;倒数第一
brand	n.烙铁;商标v.打烙印于;加商标于
gamut	n.音阶;整个范围
travesty	n.嘲弄;滑稽模仿v.使滑稽化
weld	n.焊接;焊接点v.焊接;焊牢
funk	n.恐慌;懦夫v.害怕;抽
jiffy	n.一会儿
muck	n.厩肥;污物v.把...弄脏;施厩肥于
nestle	v.抱;偎依
titular	adj.名义上的;有称号的n.有称号的人
trowel	n.小铲子;镘刀v.用镘刀涂抹
capitalism	n.资本主义
postmark	n.邮戳v.盖邮戳于
admittedly	adv.公认地
propound	v.提出...请求验证
intersect	v.贯穿;相交
lout	n.笨拙的人v.鄙视;鞠躬
minuet	n.米奴哀舞小步舞
phlegm	n.懒散;痰
ski	n.滑橇;雪板v.在...上滑雪;滑雪
weed	n.杂草;服装v.除;拣选
whaler	n.捕鲸船;捕鲸人
baize	n.台面呢
clearance	n.净空;清除;许可
rank	adj.极度肥沃的n.排;行列v.把...分等;级别高于
scald	adj.加热至接近沸腾的n.晒焦;烫伤v.烫伤;烫洗
senile	adj.老年的;老年期的
flagstaff	n.旗杆
nevermore	adv.永不再
outwit	v.智胜
quartet	n.四人组;四重奏
whisk	n.掸;掸帚;搅拌器v.掸;搅打
balk	n.挫折;埂v.错过;阻止
prune	n.洋李;洋李干v.剪去;删除
auditorium	n.会堂;听众席
pagoda	n.金币;塔式寺庙
selective	adj.选择的;选择性的
graft	n.嫁接;移植物v.嫁接;将...嫁接
ufo	n.不明飞行物
recline	v.斜倚;依靠
carouse	n.闹饮v.喝干;狂饮
touchstone	n.检验标准;试金石
flake	n.小薄片;玉米片v.削;离开
hoax	n.骗局v.欺骗
caption	n.标题;字幕v.给...加标题
static	adj.静的;静止的n.静电;指责
crank	adj.不稳的;怪人的n.怪人;曲柄v.曲折行进;转动曲柄
omniscient	adj.无所不知的
slum	n.贫民;贫民窟v.去贫民窟
cadaverous	adj.惨白的;死尸般的
converge	v.会合;聚集
ovation	n.热烈欢迎;小凯旋式
adhesive	adj.忘不了的;粘的n.绊创膏;粘合剂
fad	n.古怪念头;狂热
sop	n.面包片;一摊v.浸;吸干
tendon	n.钢筋束;腱
bandy	adj.向外弯的
exalt	v.颂扬;提升
joker	n.百搭;伏笔
loch	n.湖;狭长海湾
puss	n.猫咪;嘴
pugnacious	adj.好斗的
seedling	adj.籽生的;籽状的n.籽苗;籽生植物
global	adj.球形的;全球的
eject	n.投射v.喷射;驱逐
pennant	n.符尾;锦旗
puma	n.美洲狮
baboon	n.丑陋的人;狒狒
childbirth	n.分娩
economize	v.节省;节俭
abhor	v.回避;憎恶
emblematic	adj.象征的
swoop	n.飞扑;抓起v.吸;抓起
trump	n.王牌;喇叭v.胜过;出王牌
well	adj.对的;井的adv.好;很n.好;井v.涌出;流出
casualty	n.不幸事故;死者
mountebank	n.江湖骗子v.行骗;走江湖
schoolgirl	n.女生
grime	n.污垢v.将...弄脏
ok	adj.表示同意的adv.好n.同意v.批准
sucker	n.吮吸者;吸血鬼;吸盘v.欺骗
beet	n.甜菜;甜菜根
expatiate	v.漫游;细说
immodest	adj.自负的;不正派的
trudge	n.跋涉v.跋涉
inning	n.挨次轮换;局
pathology	n.病变;病理
referee	n.裁判;证明人v.审阅;担任裁判
viewpoint	n.观点
titter	n.窃笑v.窃笑
adduce	v.引证
quicksand	n.流沙
disfigure	v.伪装
slanderous	adj.诽谤的
goggle	adj.瞪视的v.转动;瞪视
jocose	adj.爱开玩笑的
smug	adj.整洁的;自命不凡的
staff	n.工作班子;全体职员v.雇用
footprint	n.脚印;轮迹
sight	n.检查;看见;视觉v.观测;看到
tack	n.系;东西v.连接;改弦易辙
stitch	n.缝法;一针v.缝;联接
wind	n.风;圈;气息v.包;绕
infraction	n.不全骨折;违犯
peroration	n.结束语;演讲
doggerel	adj.打油诗的n.打油诗;拙劣的诗
emetic	adj.催吐的n.催吐剂
locksmith	n.锁匠
exhale	v.呼;呼气
mat	n.衬垫;地席v.使缠结
procedure	n.常规;程序
monopolize	v.独占;垄断
neutralize	v.使中和;中和
tussle	n.扭打;争执v.扭打;争执
dilettante	n.半吊子
halcyon	adj.平静的;翡翠的n.神翠鸟;翡翠
upholster	v.装潢
watershed	n.分水岭;流域;转折点
harbinger	n.通报者;先遣人员v.充当...的通报者
larynx	n.喉
tangent	adj.离题的;正切的n.正切;直线区间
blazon	n.描绘;纹章v.宣布;装饰
discursive	adj.离题的;推论的;散漫的
haystack	n.大干草堆
mural	n.壁画
flail	v.胡乱摆动
nettle	n.荨麻v.惹怒
stilt	n.长脚鹬;高跷v.使踩高跷
baste	v.狠揍;痛斥
confound	v.混淆;使混乱
urbane	adj.有礼貌的
fixture	n.固定;固定物;装备
limbo	n.监狱;林波舞
corrosive	adj.腐蚀的;有害的n.腐蚀剂;有害因素
kiln	n.窑;窑房v.把...放在窑内烧
lobe	n.耳垂;叶
bewilder	v.使迷惑;使迷路
canister	n.小罐;霰弹
duct	n.导管;管v.用管道输送
makeshift	adj.权宜的n.权宜之计
dally	v.浪费;游荡
epileptic	adj.患癫痫的;癫痫的n.癫痫患者
expedite	v.发出;迅速执行
banns	n.结婚公告
debase	v.降低的成色
ocular	adj.像眼睛的;眼的n.目镜
inside	n.里面;内脏prep.在...的肚内;在...里面
lustful	adj.好色的;强壮的
warble	n.啭鸣;鞍瘤v.啭鸣唱出;啭鸣
dolphin	n.海豚;海豚座
killer	n.杀灭物;杀人者
muffler	n.手套;围巾
amulet	n.护身符
install	v.安顿;安装
nutshell	n.坚果外壳
resonance	n.共振;回声
exalt	v.颂扬;提升
meteoric	adj.大气的;流星的
release	n.发泄;放v.发泄;放出
statuesque	adj.雕像般的;庄严的
bulge	n.船腹;膨胀v.膨胀;塞满
cognac	n.白兰地
ellipse	n.椭圆
foal	n.小雌马v.产
omelette	n.煎蛋饼
pantheism	n.泛神崇拜;泛神论
classroom	n.教室
decadent	adj.堕落的n.堕落者
tenet	n.信条;原则
crux	n.关键;疑难之事
disc	n.唱片;磁盘
smuggle	v.偷运;走私
stationery	n.文具;信笺信封
imbibe	v.喝;吸入
mammal	n.哺乳动物
min	adj.小的n.分钟
monogram	n.交织字母v.把交织字母印于
potential	adj.潜在的;势的n.潜力;潜在性
scrutinize	v.详细检查
slake	v.消解;熟化
garner	n.谷仓v.获得;收集
tusk	n.长牙;尖物v.用长牙抵
etch	n.蚀刻;蚀刻剂v.铭刻;蚀刻
suck	n.吸;吸食v.吸;吸食
esthetic	adj.美学的
quibble	n.双关语v.就...作狡辩;吹毛求疵
lacquer	n.漆;漆器v.用漆涂
lather	n.汗沫;泡沫v.狠狠地打;形成皂沫
thorax	n.胸
windpipe	n.气管
laud	n.晨经;赞歌v.美
ventral	adj.腹的n.腹面
protocol	n.草案;礼仪
caretaker	n.照顾者;管理员
impolite	adj.不礼貌
curtail	v.剥夺;剪短
indicator	n.压力计;指针
saturnine	adj.挖苦的
hawser	n.缆索
slink	adj.早产的n.体弱的动物v.不足月产下
alimentary	adj.饮食的;消化的
dioxide	n.二氧化物
forswear	v.对...发伪誓;发伪誓
marksman	n.二等射手;射手
calculus	n.微积分;演算
colon	n.结肠;冒号
gram	n.克;祖母
pap	n.乳头;软食
petrol	n.汽油;石油
cataclysm	n.洪水;灾变
crucify	v.虐待;诋毁
prosperous	adj.茂盛的;兴旺的
zephyr	n.和风;西风
distort	v.扭歪;歪曲
midwinter	n.冬至;仲冬
nomad	adj.流浪的;游牧的n.流浪者
gibe	n.嘲讽v.嘲讽
hoover	n.真空吸尘器v.用吸尘器清洁
browse	v.吃;吃草
redound	v.带来;报偿
overhaul	n.彻底革新;解体检修v.彻底革新;赶上
postulate	n.公设;假定v.要求
qualm	n.恶心;内疚;疑虑
dumbfound	v.使惊呆
histrionic	adj.演戏似的;演员的
galaxy	n.星系;一群;银河
wrestler	n.摔跤运动员
disastrous	adj.极坏的;灾难性的
mango	n.芒果;泡菜
rotary	adj.轮流的;旋转的n.旋转式机器
sully	n.污点v.弄脏;变脏
clinical	adj.临床的;门诊部的
divisible	adj.可除的;可分的
migrant	adj.迁移的n.候鸟;移居者
squeamish	adj.易呕吐的;易受惊的
carnation	adj.肉红色的n.肉红色;香石竹
obtrude	v.强加;伸出
remedial	adj.补救的;补习的
tantamount	adj.等于的
trill	n.颤动;颤音v.啭鸣;滴
adolescent	adj.青春期的;青少年的n.青少年
testator	n.证人
bicycle	n.自行车v.骑自行车
outhouse	n.附属建筑;户外厕所
thyroid	adj.甲状的;甲状腺的n.甲状软骨;甲状腺
antiseptic	adj.抗菌的;防腐的;消毒的n.抗菌剂;防腐剂;消毒剂
dogmatism	n.教条主义;武断
decimal	adj.小数的;十进制的n.小数
knead	v.揉;揉成
fishy	adj.可疑的;鱼的
knuckle	n.指节;肘v.叩击;屈服
bawl	n.大叫声;号哭v.大声叫出;叫卖
lintel	n.过梁
misrule	n.混乱;治理不当v.对...治理不当
welter	n.混乱;翻腾v.浸泡
optics	n.光学
nonchalant	adj.漠不关心的
tarnish	n.失泽;瑕疵v.败坏;蒙受耻辱
blatant	adj.无耻的
crossroad	n.十字路口;转折点
washstand	n.脸盆架;盥洗盆
fatten	v.育肥;长肥
codicil	n.附加物;附录
dignify	v.使有尊严
quilt	n.被;被状物v.将...缝入;缝被
barb	n.倒钩;非洲马v.在...装倒钩;刈
commercial	adj.商品的;商业的n.商业广告;宣传
equinox	n.二分点;昼夜平分二分时刻
mumble	n.咕哝v.含糊地说;吻
touchy	adj.棘手的;敏感的
nebula	n.薄翳;星云
goody	n.老妇人;姥姥
outstrip	v.超过;经过
abstemious	adj.简单;有节制的
dudgeon	n.愤怒;柄木
stagger	n.斜罩;摇晃v.摇晃;犹豫
airplane	n.飞机
beaker	n.大口酒怀;烧杯
libretto	n.歌词;剧本
sanitation	n.公共卫生;卫生设备
weir	n.堰堤;鱼梁
lingo	n.特征语;行话
loser	n.输者;遗失者
lug	n.勒索;拖v.硬扯;拖
crate	n.板条箱;一箱的量v.用板条箱装
lung	n.肺;呼吸器官
curd	n.花椰菜心;凝乳v.凝结;凝结
trinity	n.三位一体
confront	v.使面对;迎面遇到
disband	v.分解;分散
reaper	n.收割机;收割者
illegal	adj.不合法的
jostle	n.挤v.挤;搅扰
swag	n.大量;钱财v.偷;垂下
windfall	n.意外之财;被风吹落的果实
cringe	n.卑躬屈膝v.畏缩;蜷缩
pedal	adj.垂足的;脚的n.踏板v.脚蹬;骑车
circa	prep.大约在
inscribe	v.刻;题献
peppermint	n.薄荷;薄荷糖
sedative	adj.镇静的n.镇静药
sewage	n.污水
diphtheria	n.白喉
subheading	n.副标题
offal	n.垃圾;下水
bleat	n.羊的叫声v.胡扯;抱怨
inaugurate	v.开始
leak	n.漏;漏洞v.使渗漏;漏
crusty	adj.像外壳的;有外壳的
sponsor	n.保人;倡议者v.倡议;发起
flashlight	n.闪光;手电筒
phoenix	n.凤凰;完人
mangrove	n.海榄雌;红树
ail	v.使受病痛;处境困难
climber	n.攀缘植物;攀缘者
ochre	adj.赭色的n.钱;赭色
vertebrate	adj.有椎骨的n.脊椎动物
modulation	n.调节;语调
officiate	v.行使;主持
paralyze	v.使麻痹;使无效
modicum	n.少量
bun	n.小圆面包;甜饼
pseudonym	n.假名
suitcase	n.小提箱
jaunt	n.旅行v.作短途旅行
brawn	n.膂力
glower	n.炽热体;怒视v.凝视;怒视
neuralgia	n.神经痛
sprout	n.后裔;新芽v.长出;发芽
aide	n.副官;助手
jurist	n.法学家;律师
elate	adj.兴高采烈的v.使兴奋
sluice	n.泄水管;蓄水;水闸v.冲洗;淘洗
bauble	n.笨伯杖;小玩具;廉价珠宝
converse	adj.颠倒的;相反的n.社交;谈话v.交谈
iota	n.极少量
swap	n.交换v.交换;进行交换
disable	v.使无资格
stub	n.残段;存根v.掐灭;使碰踢
houseboat	n.居住船
optional	adj.随意的
slut	n.荡妇;女郎
iteration	n.叠代;重复
quandary	n.困惑不定的境地
slight	adj.少量的;纤细的n.冷落;轻视v.忽视;看轻
subjugate	v.压住;征服
ventricle	n.腔室;室
combative	adj.好斗的
dulcet	adj.悦耳的
pontoon	n.浮舟;趸船
insomnia	n.失眠
van	n.前卫;翼
encumber	v.妨碍;阻塞
glint	n.光亮;闪光v.擦过;闪闪发光
gloat	n.心满意足v.爱慕地看
matrix	n.基质;母体
portrayal	n.表演;描绘
vertigo	n.迷惘;眩晕
aphorism	n.格言;箴言
borax	n.硼砂
compendium	n.概要;目录
cultivate	v.耕;养殖
daze	n.迷乱v.使发昏;使目眩
haw	n.山楂;树篱v.发呃声;向左转
peck	n.配克;啄v.凿;啄
tripe	n.肚肠;肚子
dredge	n.耙网;挖泥机v.撒;筛
warship	n.军舰
capstan	n.绞盘;主动轮
hello	adv.哈罗;嘿n.喂的招呼声
campfire	n.营火;营火会
loveless	adj.没有爱的
massage	n.按摩;性交v.奉承;修改
stun	n.打昏v.把...打昏;使震惊
whiten	v.使白;变白
imperil	v.使陷于危险
incidence	n.发生;归宿
outgoing	adj.将离职的;友好的
spry	adj.充满活力的
topple	v.使倒塌;倒塌
coppice	n.灌木林
crayon	n.颜色粉笔v.草拟
measurable	adj.不久的;可量的
scapegoat	n.替罪羊
delineate	v.刻划;描述
fidget	n.烦躁状态v.摆弄;坐立不安
gabble	n.废话;咯咯叫声v.咯咯叫;说废话
sensory	adj.感觉的
cog	n.轮齿;雄榫v.吻合;欺骗
hyacinth	n.风信子;红锆石
overshadow	v.给...遮暗
teacup	n.茶杯
baggy	adj.袋装的;鼓出的
consensus	n.合意;一致
duo	n.二重唱;一对
jackass	n.公驴;傻瓜
lancet	n.柳叶刀;桃尖拱
veterinary	adj.兽医的
blend	n.混和;融合v.染黑的毛;协调
niggard	adj.小气的n.小气的人v.行事吝啬
cocoon	n.茧;茧状物v.作茧
quaver	v.声音颤抖
stump	n.残余部分;树墩v.清除...中的根茬
venerate	v.敬重
fag	n.奴仆;香烟v.磨损;辛劳
brat	n.顽童;围裙
leaflet	n.传单;小叶
editorial	adj.编辑的;社论的n.社论
pair	n.一双;一条v.成对;配合
leak	n.漏;漏洞v.使渗漏;漏
nugget	n.天然金块;小块
supervise	v.监督;审阅
sadden	v.使悲伤;悲伤
aesthetic	adj.美的;美学的
crevasse	n.决口;裂隙
lath	n.板条;木板条v.给...钉板条
linguist	n.语言学家
morphine	n.吗啡
underlie	v.位于...之下;引起
cartoon	n.动画片;漫画v.给...绘草图;画漫画
colonist	n.移生动物
scrub	n.擦洗;擦洗者v.擦;擦掉
ideal	adj.观念的;理想的n.理想;努力目标
transplant	n.移植;移植器官v.移植;迁移
vein	n.翅脉;静脉v.使有脉络
apricot	adj.杏黄色的n.杏;杏子
chic	adj.漂亮的;时髦的n.漂亮;时髦
crescendo	adj.渐强的n.渐强v.逐渐增强
desperado	n.暴徒
incest	n.乱伦
aluminium	n.铝
cobra	n.眼镜蛇
cognate	adj.同源的n.亲属;同源词
overtake	v.赶上;追赶
transverse	adj.横吹的;横的n.横肌;横截轴
trend	n.趋向;走向
effusive	adj.喷发的
madhouse	n.精神病院
spittle	n.沫;唾沫
forensic	adj.辩论的;法庭的n.辩论练习;辩论学
nominee	n.被提名者
tights	n.紧身衣
shrimp	n.矮子;虾v.捕虾
cameo	n.多彩浮雕
coconut	n.椰子
jubilation	n.欢腾
studio	n.画室;音乐教室;射影棚
procure	v.取得;引起
herbaceous	adj.草本的;似绿叶的
lush	adj.繁茂的;繁荣的n.酒;酒鬼v.喝;喝酒
steppe	n.大草原;干草原
stilt	n.长脚鹬;高跷v.使踩高跷
tasty	adj.美味的;雅观的
vane	n.舵;翼;风向标
askew	adj.错误的;歪斜地adv.错;轻蔑地
portend	v.表明;预示
firebrand	n.煽动叛乱者
quagmire	n.困境;沼泽地
igneous	adj.火成的;火的
scraggy	adj.粗糙的;瘦的
shrivel	v.使枯萎;枯萎
simulate	v.假装;模仿
absent	adj.不在场的;缺乏的v.使缺席
burrow	n.地洞;住处v.掘出;在...掘洞
chit	n.小孩;芽;短信;单据
demean	v.进行;使表现;贬低
shoemaker	n.制鞋工人
deadlock	n.单闩锁;僵待v.僵持;僵持
reprisal	n.报复;赔偿
rotunda	n.圆形大厅
gaff	n.攀钩;斜桁v.欺骗;赌博
mill	n.磨;磨坊v.磨;碾碎
overdue	adj.过大的;过期的
proximate	adj.将临的;最近的
throw	n.冒险;投掷v.发射;投
complicate	v.并发;使卷入
solstice	n.至;至点
forceps	n.镊子;尾铗
bole	n.树的主干;红玄武土
corset	n.紧身褡;围腰
dub	n.击鼓;一戳v.戳;击
mentor	n.门特
secede	v.使脱离;退出
sedan	n.单舱汽艇
transcend	v.超出;胜过
transitive	adj.过渡的;及物的
departure	n.背离;开始
function	n.功能;官能v.工作;行使职责
appertain	v.属
flaunt	n.夸耀;藐视v.夸耀;藐视
slot	n.翼缝;足迹;空位v.踢入门;跟踪;安置
uninformed	adj.无生气的
cower	v.蹲;蜷缩
glossary	n.词表;专业词汇
ingratiate	v.使得到...的欢心
unlawful	adj.不法的;私生的
dinghy	n.小触板;小船
fend	n.自给的努力v.保护;抵挡
rowdy	adj.好争吵的n.粗暴而又好争吵的人
shank	n.腿肉;胫
solder	n.焊料;接合物v.焊;联结
draper	n.布商;悬挂者
hypnotism	n.催眠;催眠术
oral	adj.口的;口服的n.口试
redden	v.使变红;变红
smirk	n.假笑;傻笑v.假笑;傻笑
synopsis	n.大纲;缩写式
carmine	adj.胭脂红色的n.胭脂红
acclaim	n.欢呼v.宣布;欢呼
chute	n.陡坡;急流
honeycomb	n.蜂巢胃;蜜蜂巢v.变成蜂巢状
analytic	adj.分析的
disavow	v.否认
hump	n.驼背;驼峰v.溜放;隆起
sluggard	adj.懒怠的n.懒怠的人
compose	v.创作;收拾
eschew	v.避免
subside	v.平静;退落
waylay	v.伏击;拦截
convene	v.召集开会;集会
twirl	n.扭转;转动v.捻弄;转动
kimono	n.和服
vim	n.力量
engrave	v.雕刻;镌
rook	n.骗子;车v.骗取...的钱;行骗
upholstery	n.家具装饰用品业
manipulate	v.操纵;操作
rotund	adj.洪亮的;圆形的
callow	adj.羽毛未丰的;年幼的
foible	n.小缺点
vegetarian	adj.吃素的;蔬菜的n.食草动物;素食者
agape	adj.大张着嘴;洞开着adv.大张着嘴;洞开着n.爱筵;兄弟情谊
arterial	adj.动脉的;干线的
compatriot	n.伙伴;同国人
malign	adj.恶性的;恶意的v.诽谤
onlooker	n.旁观者
porpoise	n.海豚;鼠海豚
cash	n.钱;钱箱v.把...兑现;出
quadrant	n.象限仪
cacao	n.可可树
norm	n.标准;准则
reiterate	v.反复做
sunflower	n.向日葵;向日葵黄
hock	n.班房;典v.典
lop	n.小树枝v.剪去;砍
louse	n.虱;书虱v.清除...上的虱子
truism	n.自明之理
paucity	n.量少;小数目
facetious	adj.好开玩笑的
torso	n.躯干
giraffe	n.长颈鹿;鹿豹座
subway	n.地下过道;市区地铁
vaunt	n.夸耀;自吹自擂v.吹嘘
epidemic	adj.流行性的n.流传;流行
brothel	n.妓院
curative	adj.治疗的n.治疗法
trident	adj.三叉的n.三叉线;三叉戟
lode	n.矿脉;水路
amass	v.积聚;聚集
bewitch	v.施魔力于;使着迷
chatty	adj.爱闲聊的;聊天式的
diaphanous	adj.轻柔的;透明的
akimbo	adj.弯曲着adv.弯曲着
syringe	n.喷射器;注射器v.注射
sophist	n.诡辩者;学者
palmy	adj.茂盛的;棕榈的
recast	v.重算;重新浇铸
seasick	adj.晕船的
prosy	adj.沉闷的;散文的
agnostic	adj.不可知论的n.不可知论者
distil	v.蒸馏;渗出
disconcert	v.挫败
obituary	adj.关于死亡的n.讣告
pickpocket	n.扒手
pigtail	n.辫子;柔韧铜辫
python	n.蟒蛇;鬼魂
dour	adj.严厉的;阴郁的
underwear	n.衬衣
ion	n.离子
spoor	n.足迹v.跟踪追赶
zebra	n.斑马
tourism	n.旅游;旅游团
hallow	v.使成为神圣
hussar	n.轻骑兵
landlocked	adj.陆围的
taboo	adj.忌讳的n.忌讳;禁忌v.禁止
tapioca	n.木薯;木薯淀粉
aliment	n.精神养料;食物v.向...提供食物
somersault	n.筋斗v.翻筋斗
begrudge	v.妒忌
gash	adj.有见识的;多余的n.划开v.砍伤
ravish	v.强夺;强奸;陶醉
sear	adj.干枯的n.烙印;暮年v.烧灼;烧焦
befit	v.适合于
judicature	n.司法;司法权
leakage	n.漏;渗漏
hub	n.中心;毂;车轴
smudge	n.污迹;熏烟火堆v.弄脏;用烟熏
aphorism	n.格言;箴言
clout	n.敲击;影响v.猛击;敲击
importune	v.拉;麻烦;强求
scud	n.飞奔;拍v.飞奔;顺风行驶
separable	adj.可分隔的;使分离的
boa	n.蟒
jowl	n.颌;敲
twaddle	n.蠢话v.讲蠢话
vat	n.大桶v.把...盛入大桶
dolt	n.笨蛋
malleable	adj.可变的;易适应的
percussion	n.击发;敲击
achieve	v.达到;完成
consult	v.查阅;考虑
stipulate	v.规定;确定
madcap	adj.鲁莽的n.鲁莽的人
comport	n.行为;高脚果盘v.举动;一致
fumble	n.乱摸;失球v.乱摸;犯大错
retract	v.撤回;缩回
temper	n.性情;脾气v.回火;缓和
bombastic	adj.夸夸其谈的
cajole	v.骗取;劝诱
falsify	v.篡改;歪曲
flaccid	adj.软弱的;萎蔫的
seasonal	adj.季节的
unveil	v.除去面纱
obscenity	n.淫秽
bulkhead	n.舱壁;堤岸
ref	n.参考
upbringing	n.抚育
abysmal	adj.极坏的
fractional	adj.部分的;辅币的
galore	adj.多的
pinafore	n.围裙;围涎
barmaid	n.酒吧间女招待
emission	n.发出;发行
fiasco	n.完全失败;长颈瓶
tendril	n.卷须;卷须状物
gnu	n.牛羚
kidnap	v.绑架;诱拐
mandolin	n.曼陀林
bridesmaid	n.女傧相
lapel	n.翻领
overlap	n.互搭;互搭量v.与...互搭;互搭
primate	n.首领;首主教
blazon	n.描绘;纹章v.宣布;装饰
catarrh	n.卡他
coma	n.怠惰;昏迷
ignoramus	n.浑噩无知的人
jaguar	n.豹牌汽车;美洲豹
per	prep.按照;每
plod	n.吃力的工作v.沉重缓慢地走
buccaneer	n.海盗;冒险家v.当海盗
bra	n.奶罩
roulette	n.滚轮;轮盘赌v.给...滚压骑缝线
tragedian	n.悲剧演员;悲剧作者
broaden	v.使宽;变宽
tag	n.标签;挂襻v.标示;添加
cop	n.抓;顶v.攫;偷
wishful	adj.渴望的
abase	v.垂下;使谦卑
beatific	adj.赐福的;至福的
crease	n.折痕v.使变皱
invert	adj.转化的n.倒转物;仰拱v.倒转;转化
nipple	n.螺纹接套;乳头
synonym	n.换喻词;同义词
agog	adj.渴望着adv.渴望着
classmate	n.同班同学
pitchfork	n.干草叉;音叉v.强行把...推入
vacate	v.撤销;离;腾出
vendor	n.卖主;小贩
arson	n.放火
bombard	n.迫击炮船;射石炮v.轰击;炮击
intoxicate	v.使喝醉;使陶醉
bait	n.打尖;饵v.引诱;装饵于
bookish	adj.迂腐的
carbolic	adj.石炭酸的;用碳制的
itinerary	n.旅程;旅行记录
microwave	n.微波
oust	v.剥夺;驱逐
pyjamas	n.宽松裤;喇叭裤
audit	n.查帐v.查;旁听
laureate	adj.戴桂冠的;获奖者的n.获奖者;讴歌者v.给...戴桂冠
ramshackle	adj.腐败的
statuette	n.小雕像
append	v.附加;盖
crony	n.老朋友
deduct	v.扣除
tooth	n.口味;牙v.给...装齿;相咬
yank	n.突然的猛拉v.猛拉;猛地一拉
abstention	n.戒绝;弃权
electrode	n.电极
flier	n.飞行员
gander	n.蠢人;雄鹅v.看;漫步
hoe	n.锄v.用锄干活
plenary	adj.完全的
underrate	v.对...估计过低
mutable	adj.不定的;会变的
suffocate	v.扼制;窒息
damp	adj.潮湿的;迷乱的n.潮湿;矿井瓦斯v.封;阻尼
hiatus	n.间隙;裂口
machinist	n.机工
milestone	n.里程碑
nullify	v.使无价值;使无效
overdo	v.做得过分
perceptive	adj.感知的;理解的
capillary	adj.毛细管的;毛状的n.毛细管
warranty	n.担保;保修单
free	adj.自由的adv.免费地;松开着v.使摆脱;使自由
deciduous	adj.非永久的;脱落的
diabolic	adj.魔鬼的;凶暴的
fondle	v.爱抚;娇养
gong	n.铃碗;锣
hike	n.长途步行;提高v.拉;提高
physicist	n.物理学家
trestle	n.支架
barrage	n.复赛;火力网;拦河坝v.开火
casino	n.小别墅;赌场
improvise	v.临时做;即兴创作
plumber	n.堵漏人员;管子工
rout	n.溃退;骚乱v.击溃;翻
speciality	n.特点;特殊性
blanch	v.变白;退缩
vascular	adj.维管的;血管的
accumulate	v.堆积;积成堆
bemoan	v.哀悼;悲叹
cherub	n.漂亮的孩子;小天使
pitfall	n.陷阱
rubble	n.毛石;碎石
elope	v.私奔;逃走
linseed	n.亚麻籽
buttock	n.臀部;纵剖线
calabash	n.葫芦;加拉巴木
dandelion	n.蒲公英
ewer	n.大口水壶
objective	adj.客观的;目的的n.宾格;目的
alto	adj.中音部的n.女低音;中音乐器
colossus	n.巨人;巨像
disembark	v.使上岸;上岸
hostel	n.客栈;学生宿舍
controller	n.控制者;审计员
demerit	n.过失;记过
dude	n.城里人;人
flop	adv.砰地一声n.拍;拍击声v.猛击;拍
nudge	n.轻推v.接近;推进
conscript	adj.由应征入伍者组成的v.应用;应召
ovary	n.果心;卵巢
disinherit	v.剥夺...有权继承的遗产
concerto	n.协奏曲
primacy	n.第一位
recession	n.凹处;后退;萧条期
terrorism	n.恐怖统治;恐怖主义
bosh	n.胡说;槽
conscript	adj.由应征入伍者组成的v.应用;应召
dangle	n.悬荡v.炫示;追求
fallible	adj.容易弄错的
heterodox	adj.异教的
belittle	v.轻视
milkman	n.卖牛奶的人
autonomous	adj.自治的
condone	v.抵消;宽恕
mileage	n.英里数
asbestos	n.石棉
celibate	adj.独身的;禁欲的n.独身者;禁欲者
insulation	n.隔离;绝缘
liberal	adj.大量的;慷慨的n.自由主义者
stellar	adj.明星的;星的
satiate	adj.饱足的v.使饱足;使厌腻
baritone	adj.男中音的n.男中音
lumpy	adj.多块的
probate	n.遗嘱检验v.处...以缓刑;检验
bigamy	n.重婚
loot	n.劫掠;钱v.掠夺;抢劫
sextant	n.六分仪;六分周
bitumen	n.柏油路;沥青
copyright	n.版权v.以版权保护
cramp	n.绞痛;痉挛v.把...关住;痉挛
exemplify	v.例示;誊写
rummage	n.翻找v.翻找出;翻找
slogan	n.标语;战斗呐喊
accession	n.就职;添加v.把...登记入册
anodyne	adj.安慰人的;止痛的n.止痛药
lexicon	n.词典;词素
cartel	n.卡特尔;书面协定
purposeful	adj.坚定的;有目的的
appliance	n.器具;器械
lynch	v.以私刑处死
camera	n.暗箱;照相机
stewardess	n.女乘务员;女管家
jaundice	n.猜疑;黄疸v.使妒忌
recant	v.撤回;撤回声明
slipshod	adj.马虎的
cork	n.瓶塞;栓皮v.给...装软木;克制
magenta	adj.品红色的n.品红;品红色
minimize	v.达到最低值
overtime	adj.加班的adv.超时地n.加班;加班费
woodcut	n.木刻;木刻印版
deface	v.涂掉;损毁外观
grannie	n.祖母
wheedle	v.用甜言蜜语骗取
capricious	adj.变化无常的
guano	n.鸟粪
interloper	n.闯入者
absentee	adj.缺席者的n.不在的
acidity	n.尖刻;酸性
unsociable	adj.不合群的;偏僻的
wildcat	n.凶悍的人;野猫v.盲目钻井adj.未经批准的
numeral	adj.数字的n.数词;数字
quire	n.帖;一刀
salty	adj.海洋的;含盐的
ambrosia	n.仙果;珍馐美味
pander	n.迎合他人淫欲者v.迎合;作淫媒
specify	v.具体指定;明确地讲
invoice	n.发票v.开...的发票;托运
offshoot	n.岩枝;支族
witticism	n.妙语
afflict	v.使苦恼
emotional	adj.动感情的;感情的
propulsion	n.推进
ignition	n.点火;燃烧
swivel	n.架环;转体v.使旋转;旋转
override	v.不顾;撤销
presuppose	v.预先假定
duffer	n.笨蛋;小贩
idiomatic	adj.有许多习语的
propel	v.推动;推进
scurry	n.阵雪;小跑v.使急赶;乱转
sloppy	adj.潮湿的;溅湿的
mink	n.水貂毛皮;鼬
truncheon	n.插枝;官杖v.用棍子打
buffer	n.缓冲器;擦拭轮v.缓冲
abject	adj.可鄙的;奴性的;悲惨的
fudge	n.乳脂软糖;胡说v.回避;捏造
beehive	adj.圆锥形蜂窝状的n.蜂箱
coalesce	v.使合并;联合
insidious	adj.阴险的
sunstroke	n.日射病;中暑
engulf	v.大口吞食;吞没
howitzer	n.榴弹炮
starling	n.掠鸟;分水桩
excrement	n.排泄物
theorist	n.理论家
sawmill	n.大型锯机;锯木厂
aquarium	n.水旅馆;养鱼缸
boxer	n.斗拳狗
cryptic	adj.秘密的;隐藏的
grill	n.烤菜餐馆;烤架v.拷问;烤炙
lotion	n.洗液;濯身
palliation	n.缓和物;减轻
traction	n.牵引
whiting	n.牙鳕;垩
grovel	v.沉湎;匍匐
harlequin	n.丑角;诙谐角色
megaphone	n.喇叭筒v.用喇叭筒讲话
